movie,genres,main_genre,subgenres,release_month,release_year,budget,production_budget,domestic_gross,foreign_gross,worldwide_gross,total_profit
Foodfight!,"Action,Animation,Comedy",Action,"['Animation', 'Comedy']",12,2012,mid,45000000,0,73706,73706,-44926294
The Secret Life of Walter Mitty,"Adventure,Comedy,Drama",Adventure,"['Comedy', 'Drama']",12,2013,high,91000000,58236838,129624345,187861183,96861183
A Walk Among the Tombstones,"Action,Crime,Drama",Action,"['Crime', 'Drama']",9,2014,mid,28000000,26017685,36090902,62108587,34108587
Jurassic World,"Action,Adventure,Sci-Fi",Action,"['Adventure', 'Sci-Fi']",6,2015,high,215000000,652270625,996584239,1648854864,1433854864
The Rum Diary,"Comedy,Drama",Comedy,['Drama'],10,2011,mid,45000000,13109815,8434917,21544732,-23455268
Tangled,"Adventure,Animation,Comedy",Adventure,"['Animation', 'Comedy']",11,2010,high,260000000,200821936,385655304,586477240,326477240
John Carter,"Action,Adventure,Sci-Fi",Action,"['Adventure', 'Sci-Fi']",3,2012,high,275000000,73058679,209719421,282778100,7778100
Dinner for Schmucks,Comedy,Comedy,[],7,2010,high,69000000,73026337,13770165,86796502,17796502
The A-Team,"Action,Adventure,Thriller",Action,"['Adventure', 'Thriller']",6,2010,high,110000000,77222099,100019072,177241171,67241171
The Possession,"Horror,Mystery,Thriller",Horror,"['Mystery', 'Thriller']",8,2012,mid,14000000,49130588,33794476,82925064,68925064
Real Steel,"Action,Drama,Family",Action,"['Drama', 'Family']",10,2011,high,110000000,85463309,178417032,263880341,153880341
The Giver,"Drama,Romance,Sci-Fi",Drama,"['Romance', 'Sci-Fi']",8,2014,mid,25000000,45090374,21449831,66540205,41540205
Toy Story 3,"Adventure,Animation,Comedy",Adventure,"['Animation', 'Comedy']",6,2010,high,200000000,415004880,653874642,1068879522,868879522
Alita: Battle Angel,"Action,Adventure,Sci-Fi",Action,"['Adventure', 'Sci-Fi']",2,2019,high,170000000,85710210,317265826,402976036,232976036
The History of Love,"Drama,Romance,War",Drama,"['Romance', 'War']",11,2016,mid,20000000,0,476624,476624,-19523376
Shazam!,"Action,Adventure,Comedy",Action,"['Adventure', 'Comedy']",4,2019,high,85000000,139606856,223292877,362899733,277899733
Puss in Boots,"Action,Adventure,Animation",Action,"['Adventure', 'Animation']",10,2011,high,130000000,149260504,405726973,554987477,424987477
42,"Biography,Drama,Sport",Biography,"['Drama', 'Sport']",4,2013,mid,31000000,95020213,2450488,97470701,66470701
Life of Pi,"Adventure,Drama,Fantasy",Adventure,"['Drama', 'Fantasy']",11,2012,high,120000000,124987022,495924981,620912003,500912003
The Crazies,"Horror,Thriller",Horror,['Thriller'],2,2010,mid,19000000,39123589,17321945,56445534,37445534
The Equalizer,"Action,Crime,Thriller",Action,"['Crime', 'Thriller']",9,2014,high,55000000,101530738,91372886,192903624,137903624
Captain America: The First Avenger,"Action,Adventure,Sci-Fi",Action,"['Adventure', 'Sci-Fi']",7,2011,high,140000000,176654505,193915271,370569776,230569776
Sin City: A Dame to Kill For,"Crime,Thriller",Crime,['Thriller'],8,2014,high,65000000,13757804,26893038,40650842,-24349158
Piranha 3D,"Comedy,Horror",Comedy,['Horror'],8,2010,mid,24000000,25003155,58657005,83660160,59660160
Margaret,Drama,Drama,[],9,2011,mid,14000000,47185,576107,623292,-13376708
Ex Machina,"Drama,Mystery,Sci-Fi",Drama,"['Mystery', 'Sci-Fi']",4,2015,mid,13000000,25440971,12917421,38358392,25358392
Tower Heist,"Action,Comedy,Crime",Action,"['Comedy', 'Crime']",11,2011,high,85000000,78046570,72376376,150422946,65422946
The Smurfs,"Adventure,Animation,Comedy",Adventure,"['Animation', 'Comedy']",7,2011,high,110000000,142614158,421135165,563749323,453749323
The Mechanic,"Action,Crime,Thriller",Action,"['Crime', 'Thriller']",1,2011,mid,42500000,29121498,47225895,76347393,33847393
"Hail, Caesar!","Comedy,Drama,Music",Comedy,"['Drama', 'Music']",2,2016,mid,22000000,30080225,34080455,64160680,42160680
Ant-Man,"Action,Adventure,Comedy",Action,"['Adventure', 'Comedy']",7,2015,high,130000000,180202163,338656286,518858449,388858449
Season of the Witch,"Action,Adventure,Fantasy",Action,"['Adventure', 'Fantasy']",1,2011,mid,40000000,24827228,66299372,91126600,51126600
Hall Pass,"Comedy,Romance",Comedy,['Romance'],2,2011,high,68000000,45060734,42112741,87173475,19173475
The Croods,"Action,Adventure,Animation",Action,"['Adventure', 'Animation']",3,2013,high,135000000,187168425,385900000,573068425,438068425
Red Tails,"Action,Adventure,Drama",Action,"['Adventure', 'Drama']",1,2012,high,58000000,49876377,489121,50365498,-7634502
Something Borrowed,"Comedy,Drama,Romance",Comedy,"['Drama', 'Romance']",5,2011,mid,35000000,39046489,26037627,65084116,30084116
Tulip Fever,"Drama,History,Romance",Drama,"['History', 'Romance']",9,2017,mid,25000000,2455635,4337133,6792768,-18207232
Furry Vengeance,"Comedy,Family",Comedy,['Family'],4,2010,mid,35000000,17630465,21709712,39340177,4340177
Ramona and Beezus,"Adventure,Comedy,Family",Adventure,"['Comedy', 'Family']",7,2010,mid,15000000,26167002,1302619,27469621,12469621
Rings,"Drama,Horror,Mystery",Drama,"['Horror', 'Mystery']",2,2017,mid,25000000,27793018,55124265,82917283,57917283
A Thousand Words,"Comedy,Drama",Comedy,['Drama'],3,2012,mid,40000000,18450127,2340359,20790486,-19209514
What's Your Number?,"Comedy,Romance",Comedy,['Romance'],9,2011,mid,20000000,14011084,16152701,30163785,10163785
Samsara,"Documentary,Music",Documentary,['Music'],8,2012,low,4000000,2672413,3294258,5966671,1966671
Man of Steel,"Action,Adventure,Sci-Fi",Action,"['Adventure', 'Sci-Fi']",6,2013,high,225000000,291045518,376954000,667999518,442999518
The Wolfman,"Drama,Fantasy,Horror",Drama,"['Fantasy', 'Horror']",2,2010,high,150000000,62189884,80444474,142634358,-7365642
The Boxtrolls,"Adventure,Animation,Comedy",Adventure,"['Animation', 'Comedy']",9,2014,high,60000000,50837305,61108946,111946251,51946251
The Man Who Knew Infinity,"Biography,Drama",Biography,['Drama'],4,2016,mid,10000000,3877922,8504200,12382122,2382122
The Incredible Burt Wonderstone,"Adventure,Comedy,Fantasy",Adventure,"['Comedy', 'Fantasy']",3,2013,mid,32000000,22537881,4854728,27392609,-4607391
Dallas Buyers Club,"Biography,Drama",Biography,['Drama'],11,2013,mid,5000000,27298285,33313560,60611845,55611845
Jack Reacher,"Action,Crime,Thriller",Action,"['Crime', 'Thriller']",12,2012,high,60000000,80070736,137300000,217370736,157370736
R.I.P.D.,"Action,Adventure,Comedy",Action,"['Adventure', 'Comedy']",7,2013,high,130000000,33618855,45457823,79076678,-50923322
Clash of the Titans,"Action,Adventure,Fantasy",Action,"['Adventure', 'Fantasy']",4,2010,high,125000000,163214888,330000000,493214888,368214888
Thor,"Action,Adventure,Fantasy",Action,"['Adventure', 'Fantasy']",5,2011,high,150000000,181030624,268295994,449326618,299326618
Warcraft,"Action,Adventure,Fantasy",Action,"['Adventure', 'Fantasy']",6,2016,high,160000000,47225655,378296626,425522281,265522281
It's Kind of a Funny Story,"Comedy,Drama,Romance",Comedy,"['Drama', 'Romance']",10,2010,mid,8000000,6363628,269322,6632950,-1367050
Jack and Jill,Comedy,Comedy,[],11,2011,high,79000000,74158157,76361060,150519217,71519217
Take Me Home Tonight,"Comedy,Drama,Romance",Comedy,"['Drama', 'Romance']",3,2011,mid,19000000,6928068,648536,7576604,-11423396
Percy Jackson & the Olympians: The Lightning Thief,"Adventure,Family,Fantasy",Adventure,"['Family', 'Fantasy']",2,2010,high,95000000,88768303,134282571,223050874,128050874
She's Out of My League,"Comedy,Romance",Comedy,['Romance'],3,2010,mid,20000000,32010860,16670117,48680977,28680977
The Book Thief,"Drama,War",Drama,['War'],11,2013,mid,19000000,21488481,54598230,76086711,57086711
Conan the Barbarian,"Action,Adventure,Fantasy",Action,"['Adventure', 'Fantasy']",8,2011,high,90000000,21295021,42061112,63356133,-26643867
Interstellar,"Adventure,Drama,Sci-Fi",Adventure,"['Drama', 'Sci-Fi']",11,2014,high,165000000,188017894,478361481,666379375,501379375
World War Z,"Action,Adventure,Horror",Action,"['Adventure', 'Horror']",6,2013,high,190000000,202359711,329154939,531514650,341514650
Valentine's Day,"Comedy,Romance",Comedy,['Romance'],2,2010,high,52000000,110485654,107083674,217569328,165569328
Priest,"Action,Adventure,Fantasy",Action,"['Adventure', 'Fantasy']",5,2011,high,60000000,29136626,55017400,84154026,24154026
Dracula Untold,"Action,Drama,Fantasy",Action,"['Drama', 'Fantasy']",10,2014,high,70000000,55991880,164249843,220241723,150241723
Godzilla,"Action,Adventure,Sci-Fi",Action,"['Adventure', 'Sci-Fi']",5,2014,high,160000000,200676069,328400000,529076069,369076069
Hotel Transylvania,"Animation,Comedy,Family",Animation,"['Comedy', 'Family']",9,2012,high,85000000,148313048,230192764,378505812,293505812
Pet Sematary,"Horror,Mystery,Thriller",Horror,"['Mystery', 'Thriller']",4,2019,mid,21000000,54724696,54776450,109501146,88501146
The Kids Are All Right,"Comedy,Drama,Romance",Comedy,"['Drama', 'Romance']",7,2010,low,4000000,20811365,15464104,36275469,32275469
The Avengers,"Action,Adventure,Sci-Fi",Action,"['Adventure', 'Sci-Fi']",5,2012,high,225000000,623279547,894656350,1517935897,1292935897
Epic,"Adventure,Animation,Family",Adventure,"['Animation', 'Family']",5,2013,high,100000000,107518682,155275759,262794441,162794441
The Sweeney,"Action,Crime,Drama",Action,"['Crime', 'Drama']",3,2013,low,4500000,26345,7974021,8000366,3500366
Mr. Peabody & Sherman,"Adventure,Animation,Comedy",Adventure,"['Animation', 'Comedy']",3,2014,high,145000000,111506430,158300000,269806430,124806430
My Soul to Take,"Horror,Mystery,Thriller",Horror,"['Mystery', 'Thriller']",10,2010,mid,25000000,14744435,1983035,16727470,-8272530
Red State,"Action,Crime,Horror",Action,"['Crime', 'Horror']",9,2011,low,4000000,1065429,918167,1983596,-2016404
Please Give,"Comedy,Drama",Comedy,['Drama'],4,2010,low,3000000,4033574,536604,4570178,1570178
Eat Pray Love,"Drama,Romance",Drama,['Romance'],8,2010,high,60000000,80574010,126024779,206598789,146598789
Sanctum,"Adventure,Drama,Thriller",Adventure,"['Drama', 'Thriller']",2,2011,mid,30000000,23209310,85747788,108957098,78957098
Snitch,"Action,Drama,Thriller",Action,"['Drama', 'Thriller']",2,2013,mid,15000000,42930462,14977272,57907734,42907734
The Wedding Ringer,Comedy,Comedy,[],1,2015,mid,23000000,64460211,15711385,80171596,57171596
The Switch,"Comedy,Drama,Romance",Comedy,"['Drama', 'Romance']",8,2010,mid,19000000,27758465,22100000,49858465,30858465
Letters to Juliet,"Adventure,Comedy,Drama",Adventure,"['Comedy', 'Drama']",5,2010,mid,30000000,53032453,29116085,82148538,52148538
How to Train Your Dragon,"Action,Adventure,Animation",Action,"['Adventure', 'Animation']",3,2010,high,165000000,217581232,277289760,494870992,329870992
Shrek Forever After,"Adventure,Animation,Comedy",Adventure,"['Animation', 'Comedy']",5,2010,high,165000000,238736787,517507886,756244673,591244673
The Hobbit: An Unexpected Journey,"Adventure,Family,Fantasy",Adventure,"['Family', 'Fantasy']",12,2012,high,250000000,303003568,714000000,1017003568,767003568
The Legend of Tarzan,"Action,Adventure,Drama",Action,"['Adventure', 'Drama']",7,2016,high,180000000,126643061,222258964,348902025,168902025
Rabbit Hole,Drama,Drama,[],12,2010,mid,5000000,2229058,3975976,6205034,1205034
The Last Airbender,"Action,Adventure,Family",Action,"['Adventure', 'Family']",7,2010,high,150000000,131772187,187941694,319713881,169713881
Salt,"Action,Mystery,Thriller",Action,"['Mystery', 'Thriller']",7,2010,high,130000000,118311368,172339126,290650494,160650494
Source Code,"Action,Drama,Sci-Fi",Action,"['Drama', 'Sci-Fi']",4,2011,mid,32000000,54712227,85716272,140428499,108428499
Black Swan,"Drama,Thriller",Drama,['Thriller'],12,2010,mid,13000000,106954678,224312032,331266710,318266710
Green Zone,"Action,Drama,Thriller",Action,"['Drama', 'Thriller']",3,2010,high,100000000,35497337,62025683,97523020,-2476980
The Amazing Spider-Man,"Action,Adventure,Sci-Fi",Action,"['Adventure', 'Sci-Fi']",7,2012,high,220000000,262030663,495859604,757890267,537890267
The Killer Inside Me,"Crime,Drama,Horror",Crime,"['Drama', 'Horror']",6,2010,mid,13000000,217277,3400000,3617277,-9382723
The Sorcerer's Apprentice,"Action,Adventure,Family",Action,"['Adventure', 'Family']",7,2010,high,160000000,63150991,154835329,217986320,57986320
The Fighter,"Biography,Drama,Sport",Biography,"['Drama', 'Sport']",12,2010,mid,11000000,93617009,35645379,129262388,118262388
Little Fockers,"Comedy,Romance",Comedy,['Romance'],12,2010,high,100000000,148438600,162211974,310650574,210650574
Justice League,"Action,Adventure,Fantasy",Action,"['Adventure', 'Fantasy']",11,2017,high,300000000,229024295,426920914,655945209,355945209
Sucker Punch,"Action,Adventure,Fantasy",Action,"['Adventure', 'Fantasy']",3,2011,high,75000000,36392502,53365887,89758389,14758389
Lottery Ticket,Comedy,Comedy,[],8,2010,mid,17000000,24719879,0,24719879,7719879
The Chronicles of Narnia: The Voyage of the Dawn Treader,"Adventure,Family,Fantasy",Adventure,"['Family', 'Fantasy']",12,2010,high,155000000,104386950,313800000,418186950,263186950
The Adventures of Tintin,"Action,Adventure,Animation",Action,"['Adventure', 'Animation']",12,2011,high,130000000,77591831,296402120,373993951,243993951
Machete,"Action,Crime,Thriller",Action,"['Crime', 'Thriller']",9,2010,mid,12500000,26593646,19777324,46370970,33870970
Dear John,"Drama,Romance,War",Drama,"['Romance', 'War']",2,2010,mid,25000000,80014842,62018667,142033509,117033509
The Green Hornet,"Action,Comedy,Crime",Action,"['Comedy', 'Crime']",1,2011,high,110000000,98780042,130375461,229155503,119155503
Hanna,"Action,Drama,Thriller",Action,"['Drama', 'Thriller']",4,2011,mid,30000000,40259119,25084575,65343694,35343694
The Wolf of Wall Street,"Biography,Crime,Drama",Biography,"['Crime', 'Drama']",12,2013,high,100000000,116900694,272969720,389870414,289870414
Straw Dogs,"Action,Drama,Thriller",Action,"['Drama', 'Thriller']",9,2011,mid,25000000,10324441,929380,11253821,-13746179
Megamind,"Action,Animation,Comedy",Action,"['Animation', 'Comedy']",11,2010,high,130000000,148415853,173471355,321887208,191887208
The Young Messiah,"Drama,Fantasy",Drama,['Fantasy'],3,2016,mid,16800000,6469813,843884,7313697,-9486303
The Iron Lady,"Biography,Drama",Biography,['Drama'],1,2012,mid,14000000,29959436,85632668,115592104,101592104
Knight and Day,"Action,Adventure,Comedy",Action,"['Adventure', 'Comedy']",6,2010,high,117000000,76423035,182328335,258751370,141751370
Dylan Dog: Dead of Night,"Action,Comedy,Crime",Action,"['Comedy', 'Crime']",4,2011,mid,20000000,1186538,4907187,6093725,-13906275
Child 44,"Crime,Drama,History",Crime,"['Drama', 'History']",4,2015,high,50000000,1224330,6779891,8004221,-41995779
The Sisterhood of Night,"Drama,Mystery,Thriller",Drama,"['Mystery', 'Thriller']",4,2015,low,1000000,6870,0,6870,-993130
Selma,"Biography,Drama,History",Biography,"['Drama', 'History']",1,2015,mid,20000000,52076908,14699668,66776576,46776576
Centurion,"Action,Adventure,Drama",Action,"['Adventure', 'Drama']",8,2010,mid,15000000,123570,7761478,7885048,-7114952
Argo,"Biography,Drama,Thriller",Biography,"['Drama', 'Thriller']",10,2012,mid,44500000,136025503,91115254,227140757,182640757
Secretariat,"Biography,Drama,Family",Biography,"['Drama', 'Family']",10,2010,mid,35000000,59699513,676734,60376247,25376247
Poltergeist,"Horror,Thriller",Horror,['Thriller'],5,2015,mid,35000000,47425125,48287944,95713069,60713069
Hit & Run,"Action,Comedy",Action,['Comedy'],8,2012,mid,22000000,13749300,3467655,17216955,-4783045
The Warrior's Way,"Action,Fantasy,Western",Action,"['Fantasy', 'Western']",12,2010,mid,42000000,5666340,2847985,8514325,-33485675
Geroy,Action,Action,[],12,2015,mid,7000000,0,1545121,1545121,-5454879
Suspiria,"Fantasy,Horror,Mystery",Fantasy,"['Horror', 'Mystery']",10,2018,mid,20000000,2483472,4551143,7034615,-12965385
The Book of Eli,"Action,Adventure,Drama",Action,"['Adventure', 'Drama']",1,2010,high,80000000,94835059,63915758,158750817,78750817
Legion,"Action,Fantasy,Horror",Action,"['Fantasy', 'Horror']",1,2010,mid,26000000,40168080,27479494,67647574,41647574
The Nutcracker in 3D,"Action,Family,Fantasy",Action,"['Family', 'Fantasy']",11,2010,high,90000000,195459,20270557,20466016,-69533984
The Legend of Hercules,"Action,Adventure,Fantasy",Action,"['Adventure', 'Fantasy']",1,2014,high,70000000,18848538,40104781,58953319,-11046681
Silver Linings Playbook,"Comedy,Drama,Romance",Comedy,"['Drama', 'Romance']",11,2012,mid,21000000,132092958,104319495,236412453,215412453
Parental Guidance,"Comedy,Family",Comedy,['Family'],12,2012,mid,25000000,77267296,43565087,120832383,95832383
Goosebumps,"Adventure,Comedy,Family",Adventure,"['Comedy', 'Family']",10,2015,high,58000000,80069458,78835866,158905324,100905324
Repo Men,"Action,Crime,Sci-Fi",Action,"['Crime', 'Sci-Fi']",3,2010,mid,32000000,13942007,4253231,18195238,-13804762
The Big Year,Comedy,Comedy,[],10,2011,mid,41000000,7204138,480386,7684524,-33315476
Boyhood,Drama,Drama,[],7,2014,low,4000000,25379975,31893074,57273049,53273049
Water for Elephants,"Drama,Romance",Drama,['Romance'],4,2011,mid,38000000,58709717,58100000,116809717,78809717
Monte Carlo,"Adventure,Comedy,Family",Adventure,"['Comedy', 'Family']",7,2011,mid,20000000,23186769,16500000,39686769,19686769
Footloose,"Comedy,Drama,Music",Comedy,"['Drama', 'Music']",10,2011,mid,24000000,51802742,11187092,62989834,38989834
Ghost Rider: Spirit of Vengeance,"Action,Fantasy,Thriller",Action,"['Fantasy', 'Thriller']",2,2012,high,57000000,51774002,97443353,149217355,92217355
Winchester,"Biography,Drama,Fantasy",Biography,"['Drama', 'Fantasy']",2,2018,low,3500000,25091816,19286224,44378040,40878040
Skyfall,"Action,Adventure,Thriller",Action,"['Adventure', 'Thriller']",11,2012,high,200000000,304360277,806166704,1110526981,910526981
Jonah Hex,"Action,Drama,Fantasy",Action,"['Drama', 'Fantasy']",6,2010,mid,47000000,10547117,475579,11022696,-35977304
Dark Shadows,"Comedy,Fantasy,Horror",Comedy,"['Fantasy', 'Horror']",5,2012,high,150000000,79727149,158475519,238202668,88202668
The Belko Experiment,"Horror,Thriller",Horror,['Thriller'],3,2017,mid,5000000,10166820,1626122,11792942,6792942
Eddie the Eagle,"Biography,Comedy,Drama",Biography,"['Comedy', 'Drama']",2,2016,mid,23000000,15789389,29271091,45060480,22060480
Blended,"Comedy,Romance",Comedy,['Romance'],5,2014,mid,45000000,46290741,81700000,127990741,82990741
Lone Survivor,"Action,Biography,Drama",Action,"['Biography', 'Drama']",12,2013,mid,40000000,125095601,24709031,149804632,109804632
Ca$h,"Crime,Thriller",Crime,['Thriller'],3,2010,mid,7000000,46488,0,46488,-6953512
Paddington,"Adventure,Comedy,Family",Adventure,"['Comedy', 'Family']",1,2015,high,55000000,76223578,182565519,258789097,203789097
Jackass 3D,"Action,Comedy,Documentary",Action,"['Comedy', 'Documentary']",10,2010,mid,20000000,117229692,54456101,171685793,151685793
Blue Valentine,"Drama,Romance",Drama,['Romance'],12,2010,low,1000000,9737892,6828348,16566240,15566240
Seventh Son,"Action,Adventure,Fantasy",Action,"['Adventure', 'Fantasy']",2,2015,high,95000000,17725785,91149182,108874967,13874967
The Ides of March,"Drama,Thriller",Drama,['Thriller'],10,2011,mid,23000000,40962534,36773391,77735925,54735925
Free State of Jones,"Action,Biography,Drama",Action,"['Biography', 'Drama']",6,2016,high,50000000,20810036,2427216,23237252,-26762748
Love Ranch,"Biography,Comedy,Drama",Biography,"['Comedy', 'Drama']",6,2010,mid,25000000,137885,8264,146149,-24853851
Morning Glory,"Comedy,Drama,Romance",Comedy,"['Drama', 'Romance']",11,2010,mid,40000000,31011732,28783338,59795070,19795070
Shutter Island,"Mystery,Thriller",Mystery,['Thriller'],2,2010,high,80000000,128012934,171448848,299461782,219461782
The 5th Quarter,"Biography,Drama,Sport",Biography,"['Drama', 'Sport']",3,2011,mid,6000000,408159,0,408159,-5591841
Green Lantern,"Action,Adventure,Sci-Fi",Action,"['Adventure', 'Sci-Fi']",6,2011,high,200000000,116601172,102934320,219535492,19535492
Takers,"Action,Crime,Thriller",Action,"['Crime', 'Thriller']",8,2010,mid,32000000,57744720,12842548,70587268,38587268
Death Wish,"Action,Crime,Drama",Action,"['Crime', 'Drama']",3,2018,mid,30000000,34017028,14558937,48575965,18575965
Accidental Love,"Comedy,Romance",Comedy,['Romance'],3,2015,mid,26000000,0,135436,135436,-25864564
The Ghost Writer,"Drama,Mystery,Thriller",Drama,"['Mystery', 'Thriller']",2,2010,mid,45000000,15541549,49990942,65532491,20532491
Frankenweenie,"Animation,Comedy,Family",Animation,"['Comedy', 'Family']",10,2012,mid,39000000,35287788,45863000,81150788,42150788
Beastly,"Drama,Fantasy,Romance",Drama,"['Fantasy', 'Romance']",3,2011,mid,17000000,27865571,10162659,38028230,21028230
Freakonomics,Documentary,Documentary,[],10,2010,low,2900000,101270,71597,172867,-2727133
The Karate Kid,"Action,Drama,Family",Action,"['Drama', 'Family']",6,2010,mid,40000000,176591618,175183320,351774938,311774938
The Rite,"Drama,Horror,Mystery",Drama,"['Horror', 'Mystery']",1,2011,mid,37000000,33047633,64096354,97143987,60143987
Biutiful,"Drama,Romance",Drama,['Romance'],1,2011,mid,35000000,5101237,19586287,24687524,-10312476
The Hobbit: The Desolation of Smaug,"Adventure,Fantasy",Adventure,['Fantasy'],12,2013,high,250000000,258366855,702000000,960366855,710366855
Baggage Claim,Comedy,Comedy,[],9,2013,mid,8500000,21569509,1316327,22885836,14385836
All Good Things,"Crime,Drama,Mystery",Crime,"['Drama', 'Mystery']",12,2010,mid,20000000,582024,291593,873617,-19126383
A Walk in the Woods,"Adventure,Biography,Comedy",Adventure,"['Biography', 'Comedy']",9,2015,mid,8000000,29499394,7619964,37119358,29119358
A Nightmare on Elm Street,"Crime,Drama,Horror",Crime,"['Drama', 'Horror']",4,2010,mid,35000000,63075011,54654610,117729621,82729621
10 Cloverfield Lane,"Drama,Horror,Mystery",Drama,"['Horror', 'Mystery']",3,2016,mid,5000000,72082999,36203423,108286422,103286422
You Will Meet a Tall Dark Stranger,"Comedy,Drama,Romance",Comedy,"['Drama', 'Romance']",9,2010,mid,15000000,3247816,31000000,34247816,19247816
Welcome to the Rileys,Drama,Drama,[],10,2010,mid,10000000,152857,203062,355919,-9644081
The Lincoln Lawyer,"Crime,Drama,Thriller",Crime,"['Drama', 'Thriller']",3,2011,mid,40000000,58009200,29135886,87145086,47145086
Rango,"Adventure,Animation,Comedy",Adventure,"['Animation', 'Comedy']",3,2011,high,135000000,123477607,122246993,245724600,110724600
Step Up 3D,"Drama,Music,Romance",Drama,"['Music', 'Romance']",8,2010,mid,30000000,42400223,123488894,165889117,135889117
The Bourne Legacy,"Action,Adventure,Thriller",Action,"['Adventure', 'Thriller']",8,2012,high,125000000,113203870,167152050,280355920,155355920
Casino Jack,"Biography,Comedy,Crime",Biography,"['Comedy', 'Crime']",12,2010,mid,12500000,2039869,232317,2272186,-10227814
The Five-Year Engagement,"Comedy,Romance",Comedy,['Romance'],4,2012,mid,30000000,28700285,32923534,61623819,31623819
Diary of a Wimpy Kid,"Comedy,Drama,Family",Comedy,"['Drama', 'Family']",3,2010,mid,15000000,64003625,12950686,76954311,61954311
Kites,"Action,Drama,Romance",Action,"['Drama', 'Romance']",5,2010,mid,9200000,1685269,15469924,17155193,7955193
The Muppets,"Adventure,Comedy,Family",Adventure,"['Comedy', 'Family']",11,2011,mid,45000000,88625922,72346000,160971922,115971922
Last Vegas,"Comedy,Drama",Comedy,['Drama'],1,2013,mid,28000000,63914167,49000000,112914167,84914167
Ouija,"Horror,Mystery,Thriller",Horror,"['Mystery', 'Thriller']",10,2014,mid,5000000,50856010,52444622,103300632,98300632
Jack Ryan: Shadow Recruit,"Action,Drama,Thriller",Action,"['Drama', 'Thriller']",1,2014,high,60000000,50577412,80800000,131377412,71377412
Out of the Furnace,"Crime,Drama,Thriller",Crime,"['Drama', 'Thriller']",12,2013,mid,22000000,11330849,4103526,15434375,-6565625
Blood Done Sign My Name,Drama,Drama,[],2,2010,mid,10000000,109383,0,109383,-9890617
Moneyball,"Biography,Drama,Sport",Biography,"['Drama', 'Sport']",9,2011,high,50000000,75605492,35695343,111300835,61300835
The Lone Ranger,"Action,Adventure,Western",Action,"['Adventure', 'Western']",7,2013,high,275000000,89302115,170700000,260002115,-14997885
Doctor Strange,"Action,Adventure,Fantasy",Action,"['Adventure', 'Fantasy']",11,2016,high,165000000,232641920,443762646,676404566,511404566
Middle of Nowhere,Drama,Drama,[],10,2012,low,200000,236806,0,236806,36806
Escape Plan,"Action,Crime,Mystery",Action,"['Crime', 'Mystery']",10,2013,high,70000000,25135965,78600000,103735965,33735965
Hereafter,"Drama,Fantasy,Romance",Drama,"['Fantasy', 'Romance']",10,2010,high,50000000,32746941,75913329,108660270,58660270
The Lost City of Z,"Adventure,Biography,Drama",Adventure,"['Biography', 'Drama']",4,2017,mid,30000000,8574339,8547484,17121823,-12878177
The Back-up Plan,"Comedy,Romance",Comedy,['Romance'],4,2010,mid,35000000,37490007,37791172,75281179,40281179
The World's End,"Action,Comedy,Sci-Fi",Action,"['Comedy', 'Sci-Fi']",8,2013,mid,20000000,26004851,21503654,47508505,27508505
Cars 2,"Adventure,Animation,Comedy",Adventure,"['Animation', 'Comedy']",6,2011,high,200000000,191450875,368704508,560155383,360155383
Kill the Messenger,"Biography,Crime,Drama",Biography,"['Crime', 'Drama']",10,2014,mid,5000000,2450846,4205859,6656705,1656705
Legend of the Guardians: The Owls of Ga'Hoole,"Action,Adventure,Animation",Action,"['Adventure', 'Animation']",9,2010,high,100000000,55675313,84041404,139716717,39716717
Ghost in the Shell,"Action,Drama,Sci-Fi",Action,"['Drama', 'Sci-Fi']",3,2017,high,110000000,40563557,127347133,167910690,57910690
Resident Evil: Afterlife,"Action,Adventure,Horror",Action,"['Adventure', 'Horror']",9,2010,high,57500000,60128566,235745624,295874190,238374190
Zookeeper,"Comedy,Family,Romance",Comedy,"['Family', 'Romance']",7,2011,high,80000000,80360866,90444659,170805525,90805525
Viy,"Adventure,Fantasy,Mystery",Adventure,"['Fantasy', 'Mystery']",6,2015,mid,26000000,0,34246770,34246770,8246770
Get Him to the Greek,"Adventure,Comedy,Music",Adventure,"['Comedy', 'Music']",6,2010,mid,40000000,61153526,30302349,91455875,51455875
Edge of Darkness,"Crime,Drama,Mystery",Crime,"['Drama', 'Mystery']",1,2010,high,60000000,43313890,39498566,82812456,22812456
Iron Man 2,"Action,Adventure,Sci-Fi",Action,"['Adventure', 'Sci-Fi']",5,2010,high,170000000,312433331,308723058,621156389,451156389
Anchorman 2: The Legend Continues,Comedy,Comedy,[],12,2013,high,50000000,127352707,44833047,172185754,122185754
Same Kind of Different as Me,"Biography,Drama",Biography,['Drama'],10,2017,mid,6500000,6423605,0,6423605,-76395
Due Date,"Adventure,Comedy",Adventure,['Comedy'],11,2010,high,65000000,100539043,111200000,211739043,146739043
Hot Tub Time Machine,"Comedy,Sci-Fi",Comedy,['Sci-Fi'],3,2010,mid,36000000,50269859,15697891,65967750,29967750
That's My Boy,Comedy,Comedy,[],6,2012,high,57500000,36931089,21154146,58085235,585235
21 Jump Street,"Action,Comedy,Crime",Action,"['Comedy', 'Crime']",3,2012,mid,42000000,138447667,64364762,202812429,160812429
Brighton Rock,"Crime,Drama,Thriller",Crime,"['Drama', 'Thriller']",8,2011,mid,11000000,229653,0,229653,-10770347
Ironclad,"Action,Adventure,Drama",Action,"['Adventure', 'Drama']",7,2011,mid,25000000,0,5297411,5297411,-19702589
Red Dawn,"Action,Sci-Fi,Thriller",Action,"['Sci-Fi', 'Thriller']",11,2012,high,65000000,44806783,3357367,48164150,-16835850
RoboCop,"Action,Crime,Sci-Fi",Action,"['Crime', 'Sci-Fi']",2,2014,high,120000000,58607007,184374792,242981799,122981799
The Future,"Drama,Fantasy,Romance",Drama,"['Fantasy', 'Romance']",7,2011,low,1000000,568662,670512,1239174,239174
Wild Target,"Action,Comedy,Crime",Action,"['Comedy', 'Crime']",10,2010,mid,8000000,109338,5204856,5314194,-2685806
Broken City,"Crime,Drama,Thriller",Crime,"['Drama', 'Thriller']",1,2013,mid,35000000,19701164,14778881,34480045,-519955
Your Highness,"Adventure,Comedy,Fantasy",Adventure,"['Comedy', 'Fantasy']",4,2011,high,50000000,21596445,4525193,26121638,-23878362
Locker 13,Thriller,Thriller,[],3,2014,low,300000,3496,0,3496,-296504
I Spit on Your Grave,"Horror,Thriller",Horror,['Thriller'],10,2010,low,1750000,93051,1185420,1278471,-471529
We Need to Talk About Kevin,"Drama,Mystery,Thriller",Drama,"['Mystery', 'Thriller']",1,2012,mid,7000000,1738692,9026591,10765283,3765283
The Tourist,"Action,Adventure,Thriller",Action,"['Adventure', 'Thriller']",12,2010,high,100000000,67631157,211100212,278731369,178731369
Aloha,"Comedy,Drama,Romance",Comedy,"['Drama', 'Romance']",5,2015,mid,37000000,21052030,4335061,25387091,-11612909
Extraordinary Measures,Drama,Drama,[],1,2010,mid,31000000,12482741,3344243,15826984,-15173016
High School,Comedy,Comedy,[],6,2012,mid,10000000,139034,109099,248133,-9751867
Kick-Ass,"Action,Comedy",Action,['Comedy'],4,2010,mid,28000000,48071303,49459831,97531134,69531134
Salvation Boulevard,"Action,Comedy,Drama",Action,"['Comedy', 'Drama']",7,2011,mid,5500000,28468,0,28468,-5471532
300: Rise of an Empire,"Action,Fantasy,War",Action,"['Fantasy', 'War']",3,2014,high,110000000,106580051,224200000,330780051,220780051
Immortals,"Action,Drama,Fantasy",Action,"['Drama', 'Fantasy']",11,2011,high,75000000,83504017,128058418,211562435,136562435
Holmes & Watson,"Adventure,Comedy,Crime",Adventure,"['Comedy', 'Crime']",12,2018,mid,42000000,30568743,11357862,41926605,-73395
Incendies,"Drama,Mystery,War",Drama,"['Mystery', 'War']",9,2010,mid,6800000,6857096,9181247,16038343,9238343
The Man with the Iron Fists,Action,Action,[],11,2012,mid,15000000,15634090,6384898,22018988,7018988
The Cabin in the Woods,Horror,Horror,[],4,2012,mid,30000000,42073277,28616691,70689968,40689968
Den of Thieves,"Action,Crime,Drama",Action,"['Crime', 'Drama']",1,2018,mid,30000000,44947622,35183769,80131391,50131391
Sex and the City 2,"Comedy,Drama,Romance",Comedy,"['Drama', 'Romance']",5,2010,high,95000000,95347692,199333086,294680778,199680778
Scream 4,"Horror,Mystery",Horror,['Mystery'],4,2011,mid,40000000,38180928,57808662,95989590,55989590
The Roommate,"Drama,Thriller",Drama,['Thriller'],2,2011,mid,16000000,37300107,15245600,52545707,36545707
A Very Harold & Kumar 3D Christmas,"Adventure,Comedy",Adventure,['Comedy'],11,2011,mid,20000000,35061031,1204714,36265745,16265745
The Devil's Double,"Biography,Drama,Thriller",Biography,"['Drama', 'Thriller']",7,2011,mid,19100000,1361512,4604134,5965646,-13134354
Don't Be Afraid of the Dark,"Fantasy,Horror,Thriller",Fantasy,"['Horror', 'Thriller']",8,2011,mid,25000000,24046682,15079745,39126427,14126427
X-Men: First Class,"Action,Adventure,Sci-Fi",Action,"['Adventure', 'Sci-Fi']",6,2011,high,160000000,146408305,209000000,355408305,195408305
2 Guns,"Action,Comedy,Crime",Action,"['Comedy', 'Crime']",8,2013,high,61000000,75612460,56880555,132493015,71493015
London Fields,"Crime,Mystery,Thriller",Crime,"['Mystery', 'Thriller']",10,2018,mid,8000000,252676,181056,433732,-7566268
The Spy Next Door,"Action,Comedy,Family",Action,"['Comedy', 'Family']",1,2010,mid,28000000,24307106,22445752,46752858,18752858
Dying of the Light,"Drama,Thriller",Drama,['Thriller'],12,2014,mid,5000000,0,74639,74639,-4925361
Looper,"Action,Crime,Drama",Action,"['Crime', 'Drama']",9,2012,mid,30000000,66486205,103980200,170466405,140466405
Madagascar 3: Europe's Most Wanted,"Adventure,Animation,Comedy",Adventure,"['Animation', 'Comedy']",6,2012,high,145000000,216391482,530529789,746921271,601921271
Date Night,"Comedy,Crime,Romance",Comedy,"['Crime', 'Romance']",4,2010,high,55000000,98711404,53557629,152269033,97269033
Fort McCoy,"Drama,History,War",Drama,"['History', 'War']",8,2014,low,3000000,78948,0,78948,-2921052
Easy A,"Comedy,Drama,Romance",Comedy,"['Drama', 'Romance']",9,2010,mid,8000000,58401464,17799257,76200721,68200721
Bad Teacher,"Comedy,Romance",Comedy,['Romance'],6,2011,mid,19000000,100292856,115156141,215448997,196448997
The Strangers: Prey at Night,Horror,Horror,[],3,2018,mid,5000000,24431472,5528579,29960051,24960051
The Social Network,"Biography,Drama",Biography,['Drama'],10,2010,mid,40000000,96962694,127959441,224922135,184922135
Cats & Dogs: The Revenge of Kitty Galore,"Action,Comedy,Family",Action,"['Comedy', 'Family']",7,2010,high,85000000,43585753,69440630,113026383,28026383
Evil Dead,"Fantasy,Horror,Thriller",Fantasy,"['Horror', 'Thriller']",4,2013,mid,17000000,54239856,43538500,97778356,80778356
Ghostbusters,"Action,Comedy,Fantasy",Action,"['Comedy', 'Fantasy']",7,2016,high,144000000,128350574,100658084,229008658,85008658
N-Secure,"Crime,Drama,Thriller",Crime,"['Drama', 'Thriller']",10,2010,low,1600000,2595644,0,2595644,995644
Teenage Mutant Ninja Turtles,"Action,Adventure,Comedy",Action,"['Adventure', 'Comedy']",8,2014,high,125000000,191204754,293800000,485004754,360004754
xXx: Return of Xander Cage,"Action,Adventure,Thriller",Action,"['Adventure', 'Thriller']",1,2017,high,85000000,44898413,300134946,345033359,260033359
The Last Song,"Drama,Music,Romance",Drama,"['Music', 'Romance']",3,2010,mid,20000000,62950384,29728564,92678948,72678948
The Watch,"Action,Comedy,Horror",Action,"['Comedy', 'Horror']",7,2012,high,55000000,34353000,32777045,67130045,12130045
Pirates of the Caribbean: On Stranger Tides,"Action,Adventure,Fantasy",Action,"['Adventure', 'Fantasy']",5,2011,high,410600000,241063875,804600000,1045663875,635063875
Iron Man 3,"Action,Adventure,Sci-Fi",Action,"['Adventure', 'Sci-Fi']",5,2013,high,200000000,408992272,806400000,1215392272,1015392272
Kung Fu Panda 2,"Action,Adventure,Animation",Action,"['Adventure', 'Animation']",5,2011,high,150000000,165249063,499588484,664837547,514837547
Yogi Bear,"Adventure,Animation,Comedy",Adventure,"['Animation', 'Comedy']",12,2010,high,80000000,100246011,104528679,204774690,124774690
Standing Ovation,Musical,Musical,[],7,2010,mid,5600000,531806,0,531806,-5068194
Our Family Wedding,"Comedy,Romance",Comedy,['Romance'],3,2010,mid,14000000,20255281,1155265,21410546,7410546
Mars Needs Moms,"Adventure,Animation,Family",Adventure,"['Animation', 'Family']",3,2011,high,150000000,21392758,18157000,39549758,-110450242
Seeking a Friend for the End of the World,"Adventure,Comedy,Drama",Adventure,"['Comedy', 'Drama']",6,2012,mid,10000000,7078738,4688221,11766959,1766959
Bullet to the Head,"Action,Crime,Thriller",Action,"['Crime', 'Thriller']",2,2013,high,55000000,9489829,13108140,22597969,-32402031
3 Backyards,Drama,Drama,[],3,2011,low,300000,39475,0,39475,-260525
There Be Dragons,"Biography,Drama,War",Biography,"['Drama', 'War']",5,2011,mid,36000000,1069334,2951656,4020990,-31979010
Rise of the Planet of the Apes,"Action,Drama,Sci-Fi",Action,"['Drama', 'Sci-Fi']",8,2011,high,93000000,176760185,294226015,470986200,377986200
It's a Wonderful Afterlife,"Comedy,Drama,Fantasy",Comedy,"['Drama', 'Fantasy']",10,2010,mid,10000000,0,1642939,1642939,-8357061
The Last Exorcism,"Drama,Horror,Thriller",Drama,"['Horror', 'Thriller']",8,2010,low,1800000,41034350,29131550,70165900,68365900
The Expendables,"Action,Adventure,Thriller",Action,"['Adventure', 'Thriller']",8,2010,high,82000000,103068524,165199650,268268174,186268174
Gulliver's Travels,"Adventure,Comedy,Family",Adventure,"['Comedy', 'Family']",12,2010,high,112000000,42779261,189238587,232017848,120017848
The Reef,"Adventure,Drama,Horror",Adventure,"['Drama', 'Horror']",12,2010,mid,10000000,0,15037867,15037867,5037867
Death at a Funeral,Comedy,Comedy,[],4,2010,mid,21000000,42739347,6237886,48977233,27977233
The Beaver,Drama,Drama,[],5,2011,mid,21000000,970816,4075222,5046038,-15953962
Gangster Squad,"Action,Crime,Drama",Action,"['Crime', 'Drama']",1,2013,high,60000000,46000903,58100000,104100903,44100903
August: Osage County,"Comedy,Drama",Comedy,['Drama'],12,2013,mid,25000000,37738810,13000000,50738810,25738810
Despicable Me,"Animation,Comedy,Family",Animation,"['Comedy', 'Family']",7,2010,high,69000000,251513985,291950588,543464573,474464573
The Twilight Saga: Eclipse,"Adventure,Drama,Fantasy",Adventure,"['Drama', 'Fantasy']",6,2010,high,68000000,300531751,405571077,706102828,638102828
The Lucky One,"Drama,Romance",Drama,['Romance'],4,2012,mid,25000000,60457138,36176695,96633833,71633833
Lee Daniels' The Butler,"Biography,Drama",Biography,['Drama'],8,2013,mid,30000000,116632095,60393403,177025498,147025498
Movie 43,Comedy,Comedy,[],1,2013,mid,10000000,8840453,22324294,31164747,21164747
Arthur,"Comedy,Romance",Comedy,['Romance'],4,2011,mid,40000000,33035397,14752546,47787943,7787943
47 Ronin,"Action,Adventure,Drama",Action,"['Adventure', 'Drama']",12,2013,high,175000000,38362475,113354340,151716815,-23283185
Rock of Ages,"Comedy,Drama,Musical",Comedy,"['Drama', 'Musical']",6,2012,high,70000000,38518613,22513319,61031932,-8968068
Cyrus,"Comedy,Drama,Romance",Comedy,"['Drama', 'Romance']",6,2010,mid,7000000,7468936,2593960,10062896,3062896
Tinker Tailor Soldier Spy,"Drama,Mystery,Thriller",Drama,"['Mystery', 'Thriller']",12,2011,mid,21000000,24149393,57303418,81452811,60452811
Four Lions,"Comedy,Crime,Drama",Comedy,"['Crime', 'Drama']",11,2010,low,3750000,310007,2126104,2436111,-1313889
The Great Gatsby,"Drama,Romance",Drama,['Romance'],5,2013,high,190000000,144840419,206200000,351040419,161040419
Dredd,"Action,Crime,Sci-Fi",Action,"['Crime', 'Sci-Fi']",9,2012,mid,45000000,13414714,28052892,41467606,-3532394
The Dark Knight Rises,"Action,Thriller",Action,['Thriller'],7,2012,high,275000000,448139099,636300000,1084439099,809439099
Jack the Giant Slayer,"Adventure,Fantasy",Adventure,['Fantasy'],3,2013,high,195000000,65187603,132500000,197687603,2687603
If I Stay,"Drama,Fantasy,Music",Drama,"['Fantasy', 'Music']",8,2014,mid,11000000,50474843,27881327,78356170,67356170
The Infiltrator,"Biography,Crime,Drama",Biography,"['Crime', 'Drama']",7,2016,mid,47500000,15436808,5281296,20718104,-26781896
Passengers,"Drama,Romance,Sci-Fi",Drama,"['Romance', 'Sci-Fi']",12,2016,high,110000000,100014699,202224973,302239672,192239672
Black Mass,"Biography,Crime,Drama",Biography,"['Crime', 'Drama']",9,2015,high,53000000,62575678,36262194,98837872,45837872
The Extra Man,Comedy,Comedy,[],7,2010,mid,7000000,453377,38731,492108,-6507892
Tomb Raider,"Action,Adventure,Fantasy",Action,"['Adventure', 'Fantasy']",3,2018,high,90000000,58250803,215226698,273477501,183477501
Lowriders,"Adventure,Crime,Drama",Adventure,"['Crime', 'Drama']",5,2017,low,916000,6179955,8466,6188421,5272421
The Cold Light of Day,"Action,Thriller",Action,['Thriller'],9,2012,mid,20000000,3763583,21597623,25361206,5361206
Cloud Atlas,"Action,Drama,Mystery",Action,"['Drama', 'Mystery']",10,2012,high,102000000,27108272,103564882,130673154,28673154
Made in Dagenham,"Biography,Comedy,Drama",Biography,"['Comedy', 'Drama']",11,2010,mid,8000000,1095369,14548827,15644196,7644196
Pride and Prejudice and Zombies,"Action,Comedy,Horror",Action,"['Comedy', 'Horror']",2,2016,mid,28000000,10907291,5731009,16638300,-11361700
Inception,"Action,Adventure,Sci-Fi",Action,"['Adventure', 'Sci-Fi']",7,2010,high,160000000,292576195,542948447,835524642,675524642
Grown Ups,Comedy,Comedy,[],6,2010,high,75000000,162001186,110222244,272223430,197223430
Gunless,"Action,Comedy,Drama",Action,"['Comedy', 'Drama']",4,2010,mid,9900000,458054,0,458054,-9441946
The Adjustment Bureau,"Romance,Sci-Fi,Thriller",Romance,"['Sci-Fi', 'Thriller']",3,2011,high,50200000,62495645,64435680,126931325,76731325
Cop Out,"Action,Comedy,Crime",Action,"['Comedy', 'Crime']",2,2010,mid,37000000,44875481,11034429,55909910,18909910
The Other Guys,"Action,Comedy,Crime",Action,"['Comedy', 'Crime']",8,2010,high,100000000,119219978,51716492,170936470,70936470
Suicide Squad,"Action,Adventure,Fantasy",Action,"['Adventure', 'Fantasy']",8,2016,high,175000000,325100054,420959833,746059887,571059887
Downsizing,"Drama,Sci-Fi",Drama,['Sci-Fi'],12,2017,high,68000000,24449754,30013217,54462971,-13537029
We Bought a Zoo,"Comedy,Drama,Family",Comedy,"['Drama', 'Family']",12,2011,high,50000000,75624550,43104523,118729073,68729073
In the Heart of the Sea,"Action,Adventure,Biography",Action,"['Adventure', 'Biography']",12,2015,high,100000000,25020758,64672551,89693309,-10306691
The Lost Medallion: The Adventures of Billy Stone,"Adventure,Family,Fantasy",Adventure,"['Family', 'Fantasy']",3,2013,low,2500000,549632,0,549632,-1950368
Why Did I Get Married Too?,"Comedy,Drama,Romance",Comedy,"['Drama', 'Romance']",4,2010,mid,20000000,60095852,735215,60831067,40831067
The Hunger Games,"Action,Adventure,Sci-Fi",Action,"['Adventure', 'Sci-Fi']",3,2012,high,80000000,408010692,269912687,677923379,597923379
Mad Max: Fury Road,"Action,Adventure,Sci-Fi",Action,"['Adventure', 'Sci-Fi']",5,2015,high,150000000,153636354,216461666,370098020,220098020
Marmaduke,"Comedy,Family",Comedy,['Family'],6,2010,high,50000000,33644788,56251142,89895930,39895930
Prisoners,"Crime,Drama,Mystery",Crime,"['Drama', 'Mystery']",9,2013,mid,46000000,61002302,52400000,113402302,67402302
It,"Horror,Thriller",Horror,['Thriller'],9,2017,mid,35000000,327481748,369976221,697457969,662457969
Taken 2,"Action,Thriller",Action,['Thriller'],10,2012,mid,45000000,139854287,237953117,377807404,332807404
Journey 2: The Mysterious Island,"Action,Adventure,Comedy",Action,"['Adventure', 'Comedy']",2,2012,high,79000000,103860290,214285872,318146162,239146162
Straight Outta Compton,"Biography,Drama,History",Biography,"['Drama', 'History']",8,2015,mid,28000000,161197785,40985196,202182981,174182981
Transformers: Dark of the Moon,"Action,Adventure,Sci-Fi",Action,"['Adventure', 'Sci-Fi']",6,2011,high,195000000,352390543,771400000,1123790543,928790543
Winter's Bone,"Drama,Mystery",Drama,['Mystery'],6,2010,low,2000000,6531503,9600048,16131551,14131551
Happy Feet Two,"Adventure,Animation,Comedy",Adventure,"['Animation', 'Comedy']",11,2011,high,135000000,64006466,93950000,157956466,22956466
Hesher,"Comedy,Crime,Drama",Comedy,"['Crime', 'Drama']",5,2011,mid,7000000,382946,0,382946,-6617054
True Grit,"Adventure,Drama,Western",Adventure,"['Drama', 'Western']",12,2010,mid,35000000,171243005,81033923,252276928,217276928
For Colored Girls,Drama,Drama,[],11,2010,mid,21000000,37729698,288175,38017873,17017873
Just Wright,"Comedy,Romance,Sport",Comedy,"['Romance', 'Sport']",5,2010,mid,12000000,21540363,327302,21867665,9867665
Star Trek Into Darkness,"Action,Adventure,Sci-Fi",Action,"['Adventure', 'Sci-Fi']",5,2013,high,190000000,228778661,238602923,467381584,277381584
Men in Black 3,"Action,Adventure,Comedy",Action,"['Adventure', 'Comedy']",5,2012,high,215000000,179020854,475192631,654213485,439213485
Riddick,"Action,Adventure,Sci-Fi",Action,"['Adventure', 'Sci-Fi']",9,2013,mid,38000000,42025135,52738623,94763758,56763758
Bucky Larson: Born to Be a Star,Comedy,Comedy,[],9,2011,mid,10000000,2529395,0,2529395,-7470605
The Hangover Part II,"Comedy,Mystery",Comedy,['Mystery'],5,2011,high,80000000,254464305,332000000,586464305,506464305
Hop,"Adventure,Animation,Comedy",Adventure,"['Animation', 'Comedy']",4,2011,high,63000000,108085305,80572288,188657593,125657593
The Best Exotic Marigold Hotel,"Comedy,Drama,Romance",Comedy,"['Drama', 'Romance']",5,2012,mid,10000000,46383639,88256141,134639780,124639780
Table 19,"Comedy,Drama,Romance",Comedy,"['Drama', 'Romance']",3,2017,mid,5000000,3614896,1005503,4620399,-379601
12 Strong,"Action,Drama,History",Action,"['Drama', 'History']",1,2018,mid,35000000,45819713,25298665,71118378,36118378
Tracker,"Action,Adventure,Drama",Action,"['Adventure', 'Drama']",12,2011,mid,6500000,0,3149,3149,-6496851
You Again,"Comedy,Family,Romance",Comedy,"['Family', 'Romance']",9,2010,mid,20000000,25702053,7136892,32838945,12838945
"I, Frankenstein","Action,Fantasy,Horror",Action,"['Fantasy', 'Horror']",1,2014,high,65000000,19075290,55500000,74575290,9575290
Beneath Hill 60,"Drama,History,War",Drama,"['History', 'War']",6,2014,mid,9000000,0,3440939,3440939,-5559061
Somewhere,"Comedy,Drama",Comedy,['Drama'],12,2010,mid,7000000,1785645,15237476,17023121,10023121
A Lonely Place to Die,"Adventure,Crime,Thriller",Adventure,"['Crime', 'Thriller']",3,2012,low,4000000,0,442550,442550,-3557450
Barney's Version,"Comedy,Drama",Comedy,['Drama'],1,2011,mid,30000000,7502560,1343015,8845575,-21154425
Predators,"Action,Adventure,Sci-Fi",Action,"['Adventure', 'Sci-Fi']",7,2010,mid,40000000,52000688,75233701,127234389,87234389
Black Nativity,"Drama,Family,Music",Drama,"['Family', 'Music']",11,2013,mid,17500000,7018188,266947,7285135,-10214865
Hansel & Gretel: Witch Hunters,"Action,Fantasy,Horror",Action,"['Fantasy', 'Horror']",1,2013,high,50000000,55703475,159246241,214949716,164949716
The Wolverine,"Action,Adventure,Sci-Fi",Action,"['Adventure', 'Sci-Fi']",7,2013,high,115000000,132556852,283900000,416456852,301456852
Arthur Christmas,"Adventure,Animation,Comedy",Adventure,"['Animation', 'Comedy']",11,2011,high,85000000,46462469,103254655,149717124,64717124
Brick Mansions,"Action,Crime",Action,['Crime'],4,2014,mid,28000000,20396829,53024395,73421224,45421224
Big Miracle,"Biography,Drama,Family",Biography,"['Drama', 'Family']",2,2012,mid,40000000,20157300,5111380,25268680,-14731320
The Pirates! Band of Misfits,"Adventure,Animation,Comedy",Adventure,"['Animation', 'Comedy']",4,2012,high,55000000,31051126,105092479,136143605,81143605
Deadpool,"Action,Adventure,Comedy",Action,"['Adventure', 'Comedy']",2,2016,high,58000000,363070709,437954884,801025593,743025593
Faster,"Action,Crime,Drama",Action,"['Crime', 'Drama']",11,2010,mid,24000000,23240020,12552925,35792945,11792945
Fright Night,"Comedy,Horror",Comedy,['Horror'],8,2011,mid,30000000,18298649,22222000,40520649,10520649
Charlie St. Cloud,"Drama,Fantasy,Romance",Drama,"['Fantasy', 'Romance']",7,2010,mid,44000000,31206263,17271821,48478084,4478084
Battleship,"Action,Adventure,Sci-Fi",Action,"['Adventure', 'Sci-Fi']",5,2012,high,220000000,65233400,248244317,313477717,93477717
A Little Bit of Heaven,"Comedy,Drama,Fantasy",Comedy,"['Drama', 'Fantasy']",5,2012,mid,12500000,10011,1090276,1100287,-11399713
Submarine,"Comedy,Drama,Romance",Comedy,"['Drama', 'Romance']",6,2011,low,1900000,467602,4114335,4581937,2681937
The American,"Crime,Drama,Thriller",Crime,"['Drama', 'Thriller']",9,2010,mid,20000000,35606376,32344347,67950723,47950723
Martha Marcy May Marlene,"Drama,Mystery,Thriller",Drama,"['Mystery', 'Thriller']",10,2011,low,1000000,2981038,2457873,5438911,4438911
Under the Skin,"Drama,Horror,Sci-Fi",Drama,"['Horror', 'Sci-Fi']",4,2014,mid,13300000,2614251,4615682,7229933,-6070067
Quartet,"Comedy,Drama",Comedy,['Drama'],1,2013,mid,11000000,18388357,37790578,56178935,45178935
Testament of Youth,"Biography,Drama,History",Biography,"['Drama', 'History']",6,2015,mid,10000000,1822250,4824419,6646669,-3353331
Rise of the Guardians,"Action,Adventure,Animation",Action,"['Adventure', 'Animation']",11,2012,high,145000000,103412758,203488144,306900902,161900902
Prometheus,"Adventure,Mystery,Sci-Fi",Adventure,"['Mystery', 'Sci-Fi']",6,2012,high,125000000,126477084,275971181,402448265,277448265
Killer Elite,"Action,Crime,Thriller",Action,"['Crime', 'Thriller']",9,2011,high,70000000,25124986,40284060,65409046,-4590954
Winnie the Pooh,"Adventure,Animation,Comedy",Adventure,"['Animation', 'Comedy']",7,2011,mid,30000000,26692846,23452761,50145607,20145607
Monsters University,"Adventure,Animation,Comedy",Adventure,"['Animation', 'Comedy']",6,2013,high,200000000,268488329,475100000,743588329,543588329
The Help,Drama,Drama,[],8,2011,mid,25000000,169705587,43414417,213120004,188120004
Gravity,"Drama,Sci-Fi,Thriller",Drama,"['Sci-Fi', 'Thriller']",10,2013,high,110000000,274092705,419605968,693698673,583698673
The Conjuring,"Horror,Mystery,Thriller",Horror,"['Mystery', 'Thriller']",7,2013,mid,20000000,137400141,180600000,318000141,298000141
The Next Three Days,"Action,Crime,Drama",Action,"['Crime', 'Drama']",11,2010,mid,30000000,21148651,46107265,67255916,37255916
Reign of Assassins,"Action,Adventure",Action,['Adventure'],11,2016,mid,14000000,0,11354230,11354230,-2645770
Dream House,"Drama,Mystery,Thriller",Drama,"['Mystery', 'Thriller']",9,2011,high,50000000,21302340,20339826,41642166,-8357834
Letters to God,"Drama,Family",Drama,['Family'],4,2010,low,3000000,2848587,388865,3237452,237452
The Odd Life of Timothy Green,"Comedy,Drama,Family",Comedy,"['Drama', 'Family']",8,2012,mid,40000000,51853450,3395709,55249159,15249159
"Big Mommas: Like Father, Like Son","Action,Comedy,Crime",Action,"['Comedy', 'Crime']",2,2011,mid,32000000,37915414,44417036,82332450,50332450
Stake Land,"Drama,Horror,Sci-Fi",Drama,"['Horror', 'Sci-Fi']",4,2011,low,4000000,33245,646237,679482,-3320518
Baywatch,"Action,Comedy,Crime",Action,"['Comedy', 'Crime']",5,2017,high,60000000,58060186,117803597,175863783,115863783
Redemption Road,Drama,Drama,[],8,2011,low,2300000,29384,0,29384,-2270616
MacGruber,"Action,Comedy,Romance",Action,"['Comedy', 'Romance']",5,2010,mid,10000000,8525600,104295,8629895,-1370105
Max Steel,"Action,Adventure,Family",Action,"['Adventure', 'Family']",10,2016,mid,10000000,3818664,744416,4563080,-5436920
Aquaman,"Action,Adventure,Fantasy",Action,"['Adventure', 'Fantasy']",12,2018,high,160000000,335061807,811832833,1146894640,986894640
Cedar Rapids,Comedy,Comedy,[],2,2011,mid,10000000,6861102,1001029,7862131,-2137869
Bridesmaids,"Comedy,Romance",Comedy,['Romance'],5,2011,mid,32500000,169211718,120420305,289632023,257132023
Attack the Block,"Action,Comedy,Sci-Fi",Action,"['Comedy', 'Sci-Fi']",7,2011,mid,13000000,1024175,5435008,6459183,-6540817
Eddie: The Sleepwalking Cannibal,"Comedy,Horror",Comedy,['Horror'],4,2013,low,1400000,1632,0,1632,-1398368
8: The Mormon Proposition,Documentary,Documentary,[],6,2010,low,2500000,100280,0,100280,-2399720
The Greatest Showman,"Biography,Drama,Musical",Biography,"['Drama', 'Musical']",12,2017,high,84000000,174340174,212325376,386665550,302665550
Red Riding Hood,"Fantasy,Horror,Mystery",Fantasy,"['Horror', 'Mystery']",3,2011,mid,42000000,37662162,54016280,91678442,49678442
The Raven,"Crime,Mystery,Thriller",Crime,"['Mystery', 'Thriller']",4,2012,mid,26000000,16008272,14593529,30601801,4601801
5 Days of War,"Action,Drama,War",Action,"['Drama', 'War']",8,2011,mid,12000000,17479,70314,87793,-11912207
Khumba,"Adventure,Animation,Family",Adventure,"['Animation', 'Family']",12,2013,mid,15000000,0,20898221,20898221,5898221
Zambezia,"Adventure,Animation,Comedy",Adventure,"['Animation', 'Comedy']",12,2012,mid,20000000,0,34454336,34454336,14454336
The Change-Up,"Comedy,Fantasy",Comedy,['Fantasy'],8,2011,high,52000000,37243418,38753649,75997067,23997067
Central Intelligence,"Action,Comedy,Crime",Action,"['Comedy', 'Crime']",6,2016,high,50000000,127440871,89753934,217194805,167194805
The Lego Movie,"Action,Adventure,Animation",Action,"['Adventure', 'Animation']",2,2014,high,60000000,257784718,199944670,457729388,397729388
The Iceman,"Biography,Crime,Drama",Biography,"['Crime', 'Drama']",5,2013,mid,10000000,1930282,1693327,3623609,-6376391
The Paperboy,"Crime,Drama,Mystery",Crime,"['Drama', 'Mystery']",10,2012,mid,12500000,677200,3350463,4027663,-8472337
Horrible Bosses,"Comedy,Crime",Comedy,['Crime'],7,2011,mid,35000000,117538559,94879042,212417601,177417601
Drive Angry,"Action,Fantasy,Thriller",Action,"['Fantasy', 'Thriller']",2,2011,high,50000000,10721033,30321550,41042583,-8957417
Halloween,"Horror,Thriller",Horror,['Thriller'],10,2018,mid,10000000,159342015,95558652,254900667,244900667
Fantastic Four,"Action,Adventure,Drama",Action,"['Adventure', 'Drama']",8,2015,high,120000000,56117548,111731639,167849187,47849187
Haywire,"Action,Drama,Thriller",Action,"['Drama', 'Thriller']",1,2012,mid,23000000,18942396,17432304,36374700,13374700
Le Havre,"Comedy,Drama",Comedy,['Drama'],10,2011,mid,5500000,611709,12868487,13480196,7980196
Griff the Invisible,"Comedy,Drama,Romance",Comedy,"['Drama', 'Romance']",8,2011,low,2900000,20778,5157,25935,-2874065
Sherlock Holmes: A Game of Shadows,"Action,Adventure,Crime",Action,"['Adventure', 'Crime']",12,2011,high,125000000,186848418,348815025,535663443,410663443
Meek's Cutoff,"Drama,Western",Drama,['Western'],4,2011,low,2000000,977772,892156,1869928,-130072
Area 51,"Horror,Sci-Fi,Thriller",Horror,"['Sci-Fi', 'Thriller']",5,2015,mid,5000000,7556,0,7556,-4992444
Contraband,"Action,Crime,Drama",Action,"['Crime', 'Drama']",1,2012,mid,25000000,66528000,31878855,98406855,73406855
The Vatican Tapes,"Horror,Thriller",Horror,['Thriller'],7,2015,mid,13000000,1784763,13144421,14929184,1929184
Vacation,"Adventure,Comedy",Adventure,['Comedy'],7,2015,mid,31000000,58884188,43422312,102306500,71306500
Grabbers,"Comedy,Horror,Sci-Fi",Comedy,"['Horror', 'Sci-Fi']",7,2013,mid,5300000,0,440821,440821,-4859179
Exodus: Gods and Kings,"Action,Adventure,Drama",Action,"['Adventure', 'Drama']",12,2014,high,140000000,65014513,203300000,268314513,128314513
Sea Rex 3D: Journey to a Prehistoric World,Documentary,Documentary,[],5,2010,mid,5000000,6096582,10418621,16515203,11515203
Everything Must Go,"Comedy,Drama",Comedy,['Drama'],5,2011,mid,5000000,2712131,108879,2821010,-2178990
Beginners,"Comedy,Drama,Romance",Comedy,"['Drama', 'Romance']",6,2011,low,3200000,5790894,8523513,14314407,11114407
Battle of the Year,"Drama,Music",Drama,['Music'],9,2013,mid,20000000,8888355,7835022,16723377,-3276623
Beautiful Boy,Drama,Drama,[],10,2018,mid,25000000,7634767,5396657,13031424,-11968576
Beyond the Black Rainbow,"Horror,Sci-Fi,Thriller",Horror,"['Sci-Fi', 'Thriller']",5,2012,low,1100000,56491,0,56491,-1043509
Captain Phillips,"Biography,Drama,Thriller",Biography,"['Drama', 'Thriller']",10,2013,high,55000000,107136417,113511767,220648184,165648184
Hope Springs,"Comedy,Drama,Romance",Comedy,"['Drama', 'Romance']",8,2012,mid,30000000,63536011,69549284,133085295,103085295
The Son of No One,"Action,Crime,Drama",Action,"['Crime', 'Drama']",11,2011,mid,15000000,30680,1117898,1148578,-13851422
Paranormal Activity 2,Horror,Horror,[],10,2010,low,3000000,84752907,92759125,177512032,174512032
Leap Year,"Drama,Romance",Drama,['Romance'],1,2010,mid,19000000,25918920,6700000,32618920,13618920
The Mortal Instruments: City of Bones,"Action,Fantasy,Horror",Action,"['Fantasy', 'Horror']",8,2013,high,60000000,31165421,44800146,75965567,15965567
Blair Witch,"Horror,Mystery,Thriller",Horror,"['Mystery', 'Thriller']",9,2016,mid,10000000,20777061,18208516,38985577,28985577
The Guard,"Comedy,Crime,Thriller",Comedy,"['Crime', 'Thriller']",7,2011,mid,6000000,5359774,15837680,21197454,15197454
Snow Flower and the Secret Fan,"Drama,History",Drama,['History'],7,2011,mid,6000000,1348205,10000000,11348205,5348205
127 Hours,"Adventure,Biography,Drama",Adventure,"['Biography', 'Drama']",11,2010,mid,18000000,18335230,41881941,60217171,42217171
The Grace Card,Drama,Drama,[],2,2011,low,200000,2430735,0,2430735,2230735
Premium Rush,"Action,Crime,Thriller",Action,"['Crime', 'Thriller']",8,2012,mid,35000000,20275446,11117755,31393201,-3606799
Another Earth,"Drama,Romance,Sci-Fi",Drama,"['Romance', 'Sci-Fi']",7,2011,low,175000,1321194,781585,2102779,1927779
Winnie Mandela,"Biography,Drama,History",Biography,"['Drama', 'History']",9,2013,mid,15000000,61847,0,61847,-14938153
Country Strong,"Drama,Music",Drama,['Music'],12,2010,mid,15000000,20218921,383066,20601987,5601987
Beautiful Creatures,"Drama,Fantasy,Romance",Drama,"['Fantasy', 'Romance']",2,2013,high,50000000,19452138,40830738,60282876,10282876
I Want Your Money,Documentary,Documentary,[],10,2010,low,400000,433588,0,433588,33588
The Devil Inside,Horror,Horror,[],1,2012,low,1000000,53262945,48496545,101759490,100759490
Higher Ground,Drama,Drama,[],8,2011,low,1800000,841056,1637,842693,-957307
Amigo,"Drama,War",Drama,['War'],8,2011,low,1500000,184705,0,184705,-1315295
Overboard,"Comedy,Romance",Comedy,['Romance'],5,2018,mid,12000000,50316123,35053707,85369830,73369830
Dolphin Tale,"Drama,Family",Drama,['Family'],9,2011,mid,37000000,72286779,23781945,96068724,59068724
Skyline,"Action,Sci-Fi,Thriller",Action,"['Sci-Fi', 'Thriller']",11,2010,mid,10000000,21416355,46848618,68264973,58264973
For Greater Glory: The True Story of Cristiada,"Drama,History,War",Drama,"['History', 'War']",6,2012,mid,12000000,5669081,4357174,10026255,-1973745
Man on a Ledge,"Action,Adventure,Crime",Action,"['Adventure', 'Crime']",1,2012,mid,42000000,18620000,31001440,49621440,7621440
The Girl with the Dragon Tattoo,"Crime,Drama,Mystery",Crime,"['Drama', 'Mystery']",12,2011,high,90000000,102515793,136858177,239373970,149373970
Tiny Furniture,"Comedy,Drama,Romance",Comedy,"['Drama', 'Romance']",11,2010,low,50000,391674,32475,424149,374149
A Dangerous Method,"Biography,Drama,Romance",Biography,"['Drama', 'Romance']",11,2011,mid,20000000,5702083,9105448,14807531,-5192469
Mortal Engines,"Action,Adventure,Fantasy",Action,"['Adventure', 'Fantasy']",12,2018,high,100000000,15951040,69336377,85287417,-14712583
The Skeleton Twins,"Comedy,Drama,Romance",Comedy,"['Drama', 'Romance']",9,2014,low,1000000,5284309,512883,5797192,4797192
Texas Chainsaw 3D,"Horror,Thriller",Horror,['Thriller'],1,2013,mid,20000000,34341945,13324068,47666013,27666013
The Dilemma,"Comedy,Drama",Comedy,['Drama'],1,2011,high,70000000,48475290,22071575,70546865,546865
House at the End of the Street,"Drama,Horror,Thriller",Drama,"['Horror', 'Thriller']",9,2012,mid,6900000,31611916,12492066,44103982,37203982
Larry Crowne,"Comedy,Drama,Romance",Comedy,"['Drama', 'Romance']",7,2011,mid,30000000,35608245,25840890,61449135,31449135
G.I. Joe: Retaliation,"Action,Adventure,Sci-Fi",Action,"['Adventure', 'Sci-Fi']",3,2013,high,140000000,122523060,253217645,375740705,235740705
The Last Godfather,"Comedy,Crime,Romance",Comedy,"['Crime', 'Romance']",4,2011,mid,13400000,164247,0,164247,-13235753
What to Expect When You're Expecting,"Comedy,Drama,Romance",Comedy,"['Drama', 'Romance']",5,2012,mid,37500000,41152203,47320813,88473016,50973016
Burlesque,Drama,Drama,[],11,2010,high,55000000,39440655,51112020,90552675,35552675
Machine Gun Preacher,"Action,Biography,Crime",Action,"['Biography', 'Crime']",9,2011,mid,30000000,538690,3183298,3721988,-26278012
Maleficent,"Action,Adventure,Family",Action,"['Adventure', 'Family']",5,2014,high,180000000,241407328,517129407,758536735,578536735
Warm Bodies,"Comedy,Horror,Romance",Comedy,"['Horror', 'Romance']",2,2013,mid,30000000,66380662,48740946,115121608,85121608
"Jeff, Who Lives at Home","Comedy,Drama",Comedy,['Drama'],3,2012,mid,10000000,4269426,438701,4708127,-5291873
The Commuter,"Action,Mystery,Thriller",Action,"['Mystery', 'Thriller']",1,2018,mid,40000000,36343858,65641573,101985431,61985431
Insidious,"Horror,Mystery,Thriller",Horror,"['Mystery', 'Thriller']",4,2011,low,1500000,54009150,45861736,99870886,98370886
Act of Valor,"Action,Adventure,Drama",Action,"['Adventure', 'Drama']",2,2012,mid,12000000,70012847,12484188,82497035,70497035
Lockout,"Action,Sci-Fi,Thriller",Action,"['Sci-Fi', 'Thriller']",4,2012,mid,20000000,14326865,19616184,33943049,13943049
LOL,"Comedy,Drama,Romance",Comedy,"['Drama', 'Romance']",5,2012,mid,11000000,0,10431506,10431506,-568494
The Innkeepers,"Drama,Horror,Mystery",Drama,"['Horror', 'Mystery']",2,2012,low,750000,78396,933139,1011535,261535
Norm of the North,"Adventure,Animation,Comedy",Adventure,"['Animation', 'Comedy']",1,2016,mid,18000000,17062499,13473161,30535660,12535660
Fast Five,"Action,Crime,Thriller",Action,"['Crime', 'Thriller']",4,2011,high,125000000,210031325,420132129,630163454,505163454
Soul Surfer,"Biography,Drama,Family",Biography,"['Drama', 'Family']",4,2011,mid,18000000,43853424,3305228,47158652,29158652
This Means War,"Action,Comedy,Romance",Action,"['Comedy', 'Romance']",2,2012,high,65000000,54760791,102213766,156974557,91974557
The Big Short,"Biography,Comedy,Drama",Biography,"['Comedy', 'Drama']",12,2015,mid,28000000,70259870,62902882,133162752,105162752
The Woman in Black,"Drama,Fantasy,Horror",Drama,"['Fantasy', 'Horror']",2,2012,mid,15000000,54333290,74622608,128955898,113955898
Contagion,"Action,Drama,Thriller",Action,"['Drama', 'Thriller']",9,2011,high,60000000,75658097,61893497,137551594,77551594
One for the Money,"Action,Comedy,Crime",Action,"['Comedy', 'Crime']",1,2012,mid,42000000,26414527,9782694,36197221,-5802779
The Grey,"Action,Adventure,Drama",Action,"['Adventure', 'Drama']",1,2012,mid,25000000,51580136,29669040,81249176,56249176
Albert Nobbs,"Drama,Romance",Drama,['Romance'],12,2011,mid,7500000,3014696,5524307,8539003,1039003
Only God Forgives,"Crime,Drama",Crime,['Drama'],7,2013,low,4800000,775849,3718711,4494560,-305440
Amour,"Drama,Romance",Drama,['Romance'],12,2012,mid,9700000,6738954,30048090,36787044,27087044
Prom,"Comedy,Drama,Family",Comedy,"['Drama', 'Family']",4,2011,mid,8000000,10130219,632964,10763183,2763183
American Reunion,Comedy,Comedy,[],4,2012,high,50000000,56758835,180040376,236799211,186799211
Midnight in Paris,"Comedy,Fantasy,Romance",Comedy,"['Fantasy', 'Romance']",5,2011,mid,30000000,56816662,105686112,162502774,132502774
A Good Day to Die Hard,"Action,Thriller",Action,['Thriller'],2,2013,high,92000000,67349198,236900000,304249198,212249198
The Vow,"Drama,Romance",Drama,['Romance'],2,2012,mid,30000000,125014030,72604130,197618160,167618160
The Other Dream Team,"Documentary,Sport",Documentary,['Sport'],9,2012,low,500000,134109,180335,314444,-185556
Zoolander 2,Comedy,Comedy,[],2,2016,high,50000000,28848693,26500000,55348693,5348693
Abraham Lincoln: Vampire Hunter,"Action,Fantasy,Horror",Action,"['Fantasy', 'Horror']",6,2012,high,67500000,37519139,99970591,137489730,69989730
Rubber,"Comedy,Fantasy,Horror",Comedy,"['Fantasy', 'Horror']",4,2011,low,500000,100370,580544,680914,180914
Savages,"Crime,Drama,Thriller",Crime,"['Drama', 'Thriller']",7,2012,mid,45000000,47323100,35190390,82513490,37513490
Margin Call,"Drama,Thriller",Drama,['Thriller'],10,2011,low,3400000,5353586,15079641,20433227,17033227
Alvin and the Chipmunks: Chipwrecked,"Adventure,Animation,Comedy",Adventure,"['Animation', 'Comedy']",12,2011,high,80000000,133107389,215981134,349088523,269088523
J. Edgar,"Biography,Crime,Drama",Biography,"['Crime', 'Drama']",11,2011,mid,35000000,37306030,47300000,84606030,49606030
Jupiter Ascending,"Action,Adventure,Sci-Fi",Action,"['Adventure', 'Sci-Fi']",2,2015,high,179000000,47482519,134500000,181982519,2982519
Dum Maaro Dum,"Action,Crime,Drama",Action,"['Crime', 'Drama']",4,2011,mid,5200000,564489,11068938,11633427,6433427
The Last Witch Hunter,"Action,Adventure,Fantasy",Action,"['Adventure', 'Fantasy']",10,2015,high,80000000,27367660,103451252,130818912,50818912
A Wrinkle in Time,"Adventure,Family,Fantasy",Adventure,"['Family', 'Fantasy']",3,2018,high,103000000,100478608,32923274,133401882,30401882
Bleed for This,"Biography,Drama,Sport",Biography,"['Drama', 'Sport']",11,2016,mid,16000000,5083906,1520020,6603926,-9396074
Free Birds,"Adventure,Animation,Comedy",Adventure,"['Animation', 'Comedy']",11,2013,high,55000000,55750480,54636592,110387072,55387072
Think Like a Man,"Comedy,Romance",Comedy,['Romance'],4,2012,mid,12000000,91547205,21826559,113373764,101373764
30 Minutes or Less,"Action,Comedy,Crime",Action,"['Comedy', 'Crime']",8,2011,mid,28000000,37053924,3912792,40966716,12966716
Final Destination 5,Horror,Horror,[],8,2011,mid,40000000,42587643,112423522,155011165,115011165
Oz the Great and Powerful,"Adventure,Family,Fantasy",Adventure,"['Family', 'Fantasy']",3,2013,high,200000000,234770996,255588055,490359051,290359051
ParaNorman,"Adventure,Animation,Comedy",Adventure,"['Animation', 'Comedy']",8,2012,high,60000000,56003051,52116611,108119662,48119662
Young Adult,"Comedy,Drama",Comedy,['Drama'],12,2011,mid,12000000,16311571,6438785,22750356,10750356
Independence Day: Resurgence,"Action,Adventure,Sci-Fi",Action,"['Adventure', 'Sci-Fi']",6,2016,high,165000000,103144286,281025138,384169424,219169424
Blackthorn,"Action,Adventure,Western",Action,"['Adventure', 'Western']",10,2011,low,4500000,200558,1016749,1217307,-3282693
Chasing Mavericks,"Biography,Drama,Sport",Biography,"['Drama', 'Sport']",10,2012,mid,20000000,6002756,2298065,8300821,-11699179
Courageous,Drama,Drama,[],9,2011,low,2000000,34522221,663663,35185884,33185884
Edge of Tomorrow,"Action,Sci-Fi",Action,['Sci-Fi'],6,2014,high,178000000,100206256,270335000,370541256,192541256
Friends with Benefits,"Comedy,Romance",Comedy,['Romance'],7,2011,mid,35000000,55802754,90793137,146595891,111595891
Shark Night 3D,"Horror,Thriller",Horror,['Thriller'],9,2011,mid,25000000,18877153,0,18877153,-6122847
Johnny English Reborn,"Action,Adventure,Comedy",Action,"['Adventure', 'Comedy']",10,2011,mid,45000000,8406711,156233690,164640401,119640401
In Time,"Action,Crime,Drama",Action,"['Crime', 'Drama']",10,2011,mid,35000000,37553932,127550020,165103952,130103952
Our Idiot Brother,"Comedy,Drama",Comedy,['Drama'],8,2011,mid,5000000,24814830,1046419,25861249,20861249
Ted,"Comedy,Fantasy",Comedy,['Fantasy'],6,2012,high,50000000,218665740,337350887,556016627,506016627
Hobo with a Shotgun,"Action,Comedy,Horror",Action,"['Comedy', 'Horror']",5,2011,low,3000000,703372,131581,834953,-2165047
Jumping the Broom,"Comedy,Drama",Comedy,['Drama'],5,2011,mid,7000000,37295394,863207,38158601,31158601
A Few Best Men,"Comedy,Romance",Comedy,['Romance'],5,2015,mid,15000000,0,17224539,17224539,2224539
Skin Trade,"Action,Crime,Thriller",Action,"['Crime', 'Thriller']",5,2015,mid,9000000,1242,0,1242,-8998758
The Art of Getting By,"Drama,Romance",Drama,['Romance'],6,2011,low,4000000,1430241,558794,1989035,-2010965
Inside Job,"Crime,Documentary",Crime,['Documentary'],10,2010,low,2000000,4311834,3487423,7799257,5799257
The Dictator,Comedy,Comedy,[],5,2012,high,65000000,59650222,120498675,180148897,115148897
How to Train Your Dragon 2,"Action,Adventure,Animation",Action,"['Adventure', 'Animation']",6,2014,high,145000000,177002924,437583346,614586270,469586270
Wrath of the Titans,"Action,Adventure,Fantasy",Action,"['Adventure', 'Fantasy']",3,2012,high,150000000,83670083,221600000,305270083,155270083
Million Dollar Arm,"Biography,Drama,Sport",Biography,"['Drama', 'Sport']",5,2014,mid,25000000,36447959,2769953,39217912,14217912
Here Comes the Boom,"Action,Comedy,Sport",Action,"['Comedy', 'Sport']",10,2012,mid,42000000,45290318,27948940,73239258,31239258
The Dark Tower,"Action,Adventure,Fantasy",Action,"['Adventure', 'Fantasy']",8,2017,high,60000000,50701325,62760202,113461527,53461527
The Impossible,"Drama,History,Thriller",Drama,"['History', 'Thriller']",12,2012,mid,40000000,19019882,150570724,169590606,129590606
Diary of a Wimpy Kid: Rodrick Rules,"Comedy,Family",Comedy,['Family'],3,2011,mid,18000000,52698535,20996659,73695194,55695194
Super 8,"Mystery,Sci-Fi,Thriller",Mystery,"['Sci-Fi', 'Thriller']",6,2011,high,50000000,127004179,130968566,257972745,207972745
Kick-Ass 2,"Action,Comedy,Crime",Action,"['Comedy', 'Crime']",8,2013,mid,28000000,28795985,34333924,63129909,35129909
My Week with Marilyn,"Biography,Drama",Biography,['Drama'],11,2011,mid,10000000,14597405,19643167,34240572,24240572
The Age of Adaline,"Drama,Fantasy,Romance",Drama,"['Fantasy', 'Romance']",4,2015,mid,30000000,42629776,26354760,68984536,38984536
Colombiana,"Action,Drama,Thriller",Action,"['Drama', 'Thriller']",8,2011,mid,40000000,36665854,35629408,72295262,32295262
Freeheld,"Biography,Drama,Romance",Biography,"['Drama', 'Romance']",10,2015,mid,7000000,546201,1186027,1732228,-5267772
The Perks of Being a Wallflower,Drama,Drama,[],9,2012,mid,13000000,17742948,15326355,33069303,20069303
Grudge Match,"Comedy,Drama,Sport",Comedy,"['Drama', 'Sport']",12,2013,mid,40000000,29807260,40000000,69807260,29807260
Polisse,"Crime,Drama",Crime,['Drama'],5,2012,mid,8900000,176988,22567144,22744132,13844132
Fun Size,"Adventure,Comedy",Adventure,['Comedy'],10,2012,mid,14000000,9409538,1757077,11166615,-2833385
Pacific Rim,"Action,Adventure,Sci-Fi",Action,"['Adventure', 'Sci-Fi']",7,2013,high,190000000,101802906,309200000,411002906,221002906
Middle Men,"Action,Comedy,Crime",Action,"['Comedy', 'Crime']",8,2010,mid,20000000,754301,0,754301,-19245699
All Eyez on Me,"Biography,Drama,Music",Biography,"['Drama', 'Music']",6,2017,mid,45000000,44922302,9954553,54876855,9876855
Vampires Suck,Comedy,Comedy,[],8,2010,mid,20000000,36661504,44763484,81424988,61424988
Damsels in Distress,"Comedy,Drama,Romance",Comedy,"['Drama', 'Romance']",4,2012,low,3000000,1007535,316764,1324299,-1675701
Deadfall,"Crime,Drama,Thriller",Crime,"['Drama', 'Thriller']",12,2012,mid,6000000,66351,1607284,1673635,-4326365
Mirror Mirror,"Adventure,Comedy,Drama",Adventure,"['Comedy', 'Drama']",3,2012,high,85000000,64935167,108678315,173613482,88613482
Ice Age: Continental Drift,"Adventure,Animation,Comedy",Adventure,"['Animation', 'Comedy']",7,2012,high,95000000,161321843,718443294,879765137,784765137
The Sapphires,"Biography,Comedy,Drama",Biography,"['Comedy', 'Drama']",3,2013,mid,9000000,2450867,17944173,20395040,11395040
Entourage,Comedy,Comedy,[],6,2015,mid,30000000,32363404,14075134,46438538,16438538
Take Shelter,"Drama,Horror,Thriller",Drama,"['Horror', 'Thriller']",9,2011,low,4750000,1728953,3243063,4972016,222016
Ready Player One,"Action,Adventure,Sci-Fi",Action,"['Adventure', 'Sci-Fi']",3,2018,high,150000000,137690172,441599964,579290136,429290136
Trolls,"Adventure,Animation,Comedy",Adventure,"['Animation', 'Comedy']",11,2016,high,125000000,153707064,190443070,344150134,219150134
Stoker,"Drama,Thriller",Drama,['Thriller'],3,2013,mid,12000000,1703125,10331788,12034913,34913
Circumstance,Drama,Drama,[],8,2011,low,900000,454121,504857,958978,58978
Despicable Me 2,"Adventure,Animation,Comedy",Adventure,"['Animation', 'Comedy']",7,2013,high,76000000,368065385,607151450,975216835,899216835
Before I Fall,"Drama,Fantasy,Mystery",Drama,"['Fantasy', 'Mystery']",3,2017,mid,5000000,12241072,6704610,18945682,13945682
The Guilt Trip,"Comedy,Drama",Comedy,['Drama'],12,2012,mid,40000000,37134215,4160459,41294674,1294674
The Virginity Hit,Comedy,Comedy,[],9,2010,low,2000000,636706,0,636706,-1363294
"Alexander and the Terrible, Horrible, No Good, Very Bad Day","Comedy,Family",Comedy,['Family'],10,2014,mid,28000000,66954149,34425138,101379287,73379287
Peeples,"Comedy,Romance",Comedy,['Romance'],5,2013,mid,11000000,9177065,130101,9307166,-1692834
Sausage Party,"Adventure,Animation,Comedy",Adventure,"['Animation', 'Comedy']",8,2016,mid,19000000,97670358,43673897,141344255,122344255
Casa de mi Padre,"Comedy,Western",Comedy,['Western'],3,2012,mid,6000000,5909483,2537469,8446952,2446952
Justin Bieber: Never Say Never,"Documentary,Music",Documentary,['Music'],2,2011,mid,13000000,73013910,26020215,99034125,86034125
Grave Encounters,Horror,Horror,[],9,2011,low,2000000,0,2151887,2151887,151887
Chronicle,"Drama,Sci-Fi,Thriller",Drama,"['Sci-Fi', 'Thriller']",2,2012,mid,12000000,64575175,59106615,123681790,111681790
Snowpiercer,"Action,Drama,Sci-Fi",Action,"['Drama', 'Sci-Fi']",6,2014,mid,40000000,4563029,83506851,88069880,48069880
The Last Days on Mars,"Adventure,Horror,Sci-Fi",Adventure,"['Horror', 'Sci-Fi']",12,2013,mid,10600000,24084,237280,261364,-10338636
Joyful Noise,"Comedy,Drama,Music",Comedy,"['Drama', 'Music']",1,2012,mid,27500000,30932113,225801,31157914,3657914
Office Christmas Party,Comedy,Comedy,[],12,2016,mid,45000000,54767494,36555805,91323299,46323299
Alex Cross,"Action,Crime,Mystery",Action,"['Crime', 'Mystery']",10,2012,mid,35000000,25888412,9538347,35426759,426759
Triple 9,"Crime,Thriller",Crime,['Thriller'],2,2016,mid,20000000,12639297,13304495,25943792,5943792
The Spectacular Now,"Comedy,Drama,Romance",Comedy,"['Drama', 'Romance']",8,2013,low,2500000,6852971,63980,6916951,4416951
Raymond Did It,Horror,Horror,[],2,2011,low,40000,3632,0,3632,-36368
Another Happy Day,"Comedy,Drama",Comedy,['Drama'],11,2011,low,4000000,9120,969407,978527,-3021473
Vamps,"Comedy,Horror,Thriller",Comedy,"['Horror', 'Thriller']",11,2012,mid,16000000,3361,91451,94812,-15905188
October Baby,Drama,Drama,[],3,2012,low,1000000,5355847,36145,5391992,4391992
We're the Millers,"Comedy,Crime",Comedy,['Crime'],8,2013,mid,37000000,150394119,117422157,267816276,230816276
L!fe Happens,Comedy,Comedy,[],4,2012,low,930000,30905,0,30905,-899095
Before I Go to Sleep,"Drama,Horror,Mystery",Drama,"['Horror', 'Mystery']",10,2014,mid,22000000,3242457,16321122,19563579,-2436421
Killer Joe,"Crime,Drama,Thriller",Crime,"['Drama', 'Thriller']",7,2012,mid,10000000,1291645,3367465,4659110,-5340890
The Way Way Back,"Comedy,Drama",Comedy,['Drama'],7,2013,mid,5000000,21502690,5351120,26853810,21853810
Scouts Guide to the Zombie Apocalypse,"Action,Comedy,Horror",Action,"['Comedy', 'Horror']",10,2015,mid,15000000,3703046,11851809,15554855,554855
Bohemian Rhapsody,"Biography,Drama,Music",Biography,"['Drama', 'Music']",11,2018,high,55000000,216303339,678682003,894985342,839985342
Darling Companion,"Comedy,Drama,Romance",Comedy,"['Drama', 'Romance']",4,2012,mid,12000000,793352,406994,1200346,-10799654
Ender's Game,"Action,Adventure,Fantasy",Action,"['Adventure', 'Fantasy']",11,2013,high,110000000,61737191,66246092,127983283,17983283
The Lords of Salem,"Horror,Thriller",Horror,['Thriller'],4,2013,low,1500000,1165881,375250,1541131,41131
50/50,Documentary,Documentary,[],9,2011,mid,8000000,35016118,6318617,41334735,33334735
Snow White and the Huntsman,"Action,Adventure,Drama",Action,"['Adventure', 'Drama']",6,2012,high,170000000,155136755,245884991,401021746,231021746
Secret in Their Eyes,"Crime,Drama,Mystery",Crime,"['Drama', 'Mystery']",11,2015,mid,20000000,20180155,12427864,32608019,12608019
Jersey Boys,"Biography,Drama,Music",Biography,"['Drama', 'Music']",6,2014,mid,40000000,47047013,18235719,65282732,25282732
Sabotage,"Action,Crime,Drama",Action,"['Crime', 'Drama']",3,2014,mid,35000000,10508518,7867925,18376443,-16623557
Your Sister's Sister,"Comedy,Drama",Comedy,['Drama'],6,2012,low,120000,1597486,1493107,3090593,2970593
I Don't Know How She Does It,"Comedy,Romance",Comedy,['Romance'],9,2011,mid,24000000,9659074,14815389,24474463,474463
Moonrise Kingdom,"Adventure,Comedy,Drama",Adventure,"['Comedy', 'Drama']",5,2012,mid,16000000,45512466,23335980,68848446,52848446
Red Lights,"Drama,Fantasy,Horror",Drama,"['Fantasy', 'Horror']",7,2012,mid,17700000,49521,14469363,14518884,-3181116
Sound of My Voice,"Drama,Mystery,Sci-Fi",Drama,"['Mystery', 'Sci-Fi']",4,2012,low,135000,408015,21433,429448,294448
The Collection,"Action,Horror,Thriller",Action,"['Horror', 'Thriller']",11,2012,mid,10000000,6810754,2079340,8890094,-1109906
The Ghastly Love of Johnny X,"Comedy,Fantasy,Musical",Comedy,"['Fantasy', 'Musical']",10,2012,low,2000000,2436,0,2436,-1997564
Twixt,"Comedy,Fantasy,Horror",Comedy,"['Fantasy', 'Horror']",7,2013,mid,7000000,0,1268346,1268346,-5731654
Blue Like Jazz,"Comedy,Drama",Comedy,['Drama'],4,2012,low,1200000,595018,0,595018,-604982
People Like Us,Drama,Drama,[],6,2012,mid,16000000,12431792,185680,12617472,-3382528
The To Do List,"Comedy,Romance",Comedy,['Romance'],7,2013,low,1500000,3491669,637159,4128828,2628828
The Snowman,"Crime,Drama,Mystery",Crime,"['Drama', 'Mystery']",10,2017,mid,35000000,6670765,36555381,43226146,8226146
Arbitrage,"Drama,Thriller",Drama,['Thriller'],9,2012,mid,12000000,7919574,27911139,35830713,23830713
Killing Them Softly,"Crime,Thriller",Crime,['Thriller'],11,2012,mid,15000000,14945541,24292902,39238443,24238443
The Expendables 2,"Action,Adventure,Thriller",Action,"['Adventure', 'Thriller']",8,2012,high,100000000,85028192,226951064,311979256,211979256
Silent House,"Drama,Horror,Mystery",Drama,"['Horror', 'Mystery']",3,2012,low,2000000,12739737,3871023,16610760,14610760
The Giant Mechanical Man,"Comedy,Drama,Romance",Comedy,"['Drama', 'Romance']",4,2012,low,900000,7396,0,7396,-892604
Apollo 18,"Horror,Mystery,Sci-Fi",Horror,"['Mystery', 'Sci-Fi']",9,2011,mid,5000000,17686929,8830890,26517819,21517819
Danny Collins,"Biography,Comedy,Drama",Biography,"['Comedy', 'Drama']",3,2015,mid,10000000,5637066,2828779,8465845,-1534155
Wreck-It Ralph,"Adventure,Animation,Comedy",Adventure,"['Animation', 'Comedy']",11,2012,high,165000000,189412677,307098844,496511521,331511521
Trade of Innocents,"Drama,Thriller",Drama,['Thriller'],10,2012,mid,5800000,15091,0,15091,-5784909
Outside Bet,Comedy,Comedy,[],2,2015,mid,7500000,0,13524,13524,-7486476
A Star is Born,"Documentary,Music",Documentary,['Music'],10,2018,mid,36000000,215288866,218160705,433449571,397449571
50 to 1,Drama,Drama,[],3,2014,mid,10000000,1069454,0,1069454,-8930546
Paranormal Activity 3,"Horror,Mystery,Thriller",Horror,"['Mystery', 'Thriller']",10,2011,mid,5000000,104028807,103011037,207039844,202039844
Anna Karenina,"Drama,Romance",Drama,['Romance'],11,2012,mid,49000000,12816367,58188260,71004627,22004627
Hands of Stone,"Action,Biography,Drama",Action,"['Biography', 'Drama']",8,2016,mid,20000000,4712792,319183,5031975,-14968025
Elysium,Drama,Drama,[],8,2013,high,120000000,93050117,193141974,286192091,166192091
Madea's Big Happy Family,"Comedy,Drama",Comedy,['Drama'],4,2011,mid,25000000,53345287,815531,54160818,29160818
Kill List,"Crime,Drama,Horror",Crime,"['Drama', 'Horror']",2,2012,low,800000,29063,433143,462206,-337794
Pirates of the Caribbean: Dead Men Tell No Tales,"Action,Adventure,Fantasy",Action,"['Adventure', 'Fantasy']",5,2017,high,230000000,172558876,615682261,788241137,558241137
The Maze Runner,"Action,Mystery,Sci-Fi",Action,"['Mystery', 'Sci-Fi']",9,2014,mid,34000000,102427862,245891999,348319861,314319861
Zero Dark Thirty,"Drama,Thriller",Drama,['Thriller'],12,2012,high,52500000,95720716,38891719,134612435,82112435
Inherent Vice,"Comedy,Crime,Drama",Comedy,"['Crime', 'Drama']",12,2014,mid,20000000,8110975,6661371,14772346,-5227654
While We're Young,"Comedy,Drama,Mystery",Comedy,"['Drama', 'Mystery']",3,2015,mid,10000000,7582065,9921763,17503828,7503828
Cirque du Soleil: Worlds Away,Fantasy,Fantasy,[],12,2012,mid,25000000,12512862,15500000,28012862,3012862
Rudderless,"Comedy,Drama,Music",Comedy,"['Drama', 'Music']",10,2014,mid,5000000,56001,511218,567219,-4432781
Southpaw,"Drama,Sport",Drama,['Sport'],7,2015,mid,30000000,52421953,41734503,94156456,64156456
Her,"Drama,Romance,Sci-Fi",Drama,"['Romance', 'Sci-Fi']",1,2014,mid,23000000,25568251,22595564,48163815,25163815
American Hustle,"Crime,Drama",Crime,['Drama'],12,2013,mid,40000000,150117807,107760487,257878294,217878294
That Awkward Moment,"Comedy,Romance",Comedy,['Romance'],1,2014,mid,8000000,26068955,27000000,53068955,45068955
Step Up Revolution,"Drama,Music,Romance",Drama,"['Music', 'Romance']",7,2012,mid,33000000,35074677,130477613,165552290,132552290
Gotti,"Biography,Crime,Drama",Biography,"['Crime', 'Drama']",6,2018,mid,10000000,4286367,1802733,6089100,-3910900
Unbroken,"Biography,Drama,Sport",Biography,"['Drama', 'Sport']",12,2014,high,65000000,115637895,47889929,163527824,98527824
Little Boy,"Drama,History,War",Drama,"['History', 'War']",4,2015,mid,20000000,6485961,11283338,17769299,-2230701
Admission,"Comedy,Drama,Romance",Comedy,"['Drama', 'Romance']",3,2013,mid,13000000,18007317,726349,18733666,5733666
After Earth,"Action,Adventure,Drama",Action,"['Adventure', 'Drama']",5,2013,high,130000000,60522097,190977568,251499665,121499665
The Place Beyond the Pines,"Crime,Drama,Thriller",Crime,"['Drama', 'Thriller']",3,2013,mid,15000000,21403519,25607930,47011449,32011449
Freaks of Nature,"Comedy,Horror,Sci-Fi",Comedy,"['Horror', 'Sci-Fi']",10,2015,mid,33000000,70958,0,70958,-32929042
Nebraska,"Adventure,Comedy,Drama",Adventure,"['Comedy', 'Drama']",11,2013,mid,12000000,17654912,7106448,24761360,12761360
The Nut Job,"Adventure,Animation,Comedy",Adventure,"['Animation', 'Comedy']",1,2014,mid,30000000,64251538,58278428,122529966,92529966
RED 2,"Action,Comedy,Crime",Action,"['Comedy', 'Crime']",7,2013,high,84000000,53262560,88244795,141507355,57507355
Sparrows Dance,"Comedy,Drama,Romance",Comedy,"['Drama', 'Romance']",8,2013,low,175000,2602,0,2602,-172398
Chappie,"Action,Crime,Drama",Action,"['Crime', 'Drama']",3,2015,mid,49000000,31569268,73432788,105002056,56002056
Black Panther,"Action,Adventure,Sci-Fi",Action,"['Adventure', 'Sci-Fi']",2,2018,high,200000000,700059566,648198658,1348258224,1148258224
About Last Night,"Comedy,Romance",Comedy,['Romance'],2,2014,mid,13000000,48637684,1808176,50445860,37445860
Space Pirate Captain Harlock,"Animation,Sci-Fi",Animation,['Sci-Fi'],12,2013,mid,30000000,0,310985,310985,-29689015
Dhoom 3,"Action,Thriller",Action,['Thriller'],12,2013,mid,24000000,8031955,3691665,11723620,-12276380
Queen of the Desert,"Adventure,Biography,Drama",Adventure,"['Biography', 'Drama']",4,2017,mid,36000000,0,1578543,1578543,-34421457
The Fifth Estate,"Biography,Drama,Thriller",Biography,"['Drama', 'Thriller']",10,2013,mid,26000000,3254172,2900000,6154172,-19845828
The Face of Love,"Drama,Mystery,Romance",Drama,"['Mystery', 'Romance']",3,2014,low,4000000,385069,773808,1158877,-2841123
Divergent,"Action,Adventure,Mystery",Action,"['Adventure', 'Mystery']",3,2014,high,85000000,150947895,125067070,276014965,191014965
The Words,"Drama,Mystery,Romance",Drama,"['Mystery', 'Romance']",9,2012,mid,6000000,11494838,4874870,16369708,10369708
Captain America: The Winter Soldier,"Action,Adventure,Sci-Fi",Action,"['Adventure', 'Sci-Fi']",4,2014,high,170000000,259746958,454654931,714401889,544401889
Inescapable,"Action,Drama,Mystery",Action,"['Drama', 'Mystery']",2,2013,low,4000000,4327,0,4327,-3995673
Django Unchained,"Drama,Western",Drama,['Western'],12,2012,high,100000000,162805434,287142889,449948323,349948323
You're Next,"Action,Comedy,Horror",Action,"['Comedy', 'Horror']",8,2013,low,1000000,18494006,8393171,26887177,25887177
Percy Jackson: Sea of Monsters,"Adventure,Family,Fantasy",Adventure,"['Family', 'Fantasy']",8,2013,high,90000000,68559554,132300000,200859554,110859554
End of Watch,"Action,Crime,Drama",Action,"['Crime', 'Drama']",9,2012,mid,15000000,41003371,16583235,57586606,42586606
Resident Evil: Retribution,"Action,Horror,Sci-Fi",Action,"['Horror', 'Sci-Fi']",9,2012,high,65000000,42345531,198302098,240647629,175647629
Tim and Eric's Billion Dollar Movie,Comedy,Comedy,[],3,2012,low,3000000,201436,22216,223652,-2776348
Blade Runner 2049,"Drama,Mystery,Sci-Fi",Drama,"['Mystery', 'Sci-Fi']",10,2017,high,185000000,92054159,167303249,259357408,74357408
To Rome with Love,"Comedy,Music,Romance",Comedy,"['Music', 'Romance']",6,2012,mid,21500000,16684352,57641663,74326015,52826015
Dirty Grandpa,Comedy,Comedy,[],1,2016,mid,11500000,35593113,69485336,105078449,93578449
Turbo,"Adventure,Animation,Comedy",Adventure,"['Animation', 'Comedy']",7,2013,high,135000000,83028130,203868448,286896578,151896578
Deepwater Horizon,"Action,Drama,History",Action,"['Drama', 'History']",9,2016,high,156000000,61433527,61170297,122603824,-33396176
Safety Not Guaranteed,"Comedy,Drama,Romance",Comedy,"['Drama', 'Romance']",6,2012,low,750000,4010957,411361,4422318,3672318
Detention of the Dead,"Action,Adventure,Comedy",Action,"['Adventure', 'Comedy']",6,2013,low,500000,1778,0,1778,-498222
The Sessions,"Biography,Comedy,Drama",Biography,"['Comedy', 'Drama']",10,2012,low,1000000,6002451,5492753,11495204,10495204
Filly Brown,"Drama,Music",Drama,['Music'],4,2013,low,1250000,2850357,90054,2940411,1690411
The East,"Adventure,Drama,Thriller",Adventure,"['Drama', 'Thriller']",5,2013,mid,6500000,2274649,753307,3027956,-3472044
The Amazing Spider-Man 2,"Action,Adventure,Sci-Fi",Action,"['Adventure', 'Sci-Fi']",5,2014,high,200000000,202853933,506142403,708996336,508996336
Supporting Characters,Comedy,Comedy,[],1,2013,low,60000,4917,0,4917,-55083
Sparkle,"Drama,Music",Drama,['Music'],8,2012,mid,10000000,24397469,262854,24660323,14660323
X-Men: Days of Future Past,"Action,Adventure,Sci-Fi",Action,"['Adventure', 'Sci-Fi']",5,2014,high,200000000,233921534,513941241,747862775,547862775
The Edge of Seventeen,"Comedy,Drama",Comedy,['Drama'],11,2016,mid,9000000,14431633,4664370,19096003,10096003
Newlyweds,"Comedy,Drama",Comedy,['Drama'],1,2012,low,9000,4584,0,4584,-4416
Parker,"Action,Crime,Thriller",Action,"['Crime', 'Thriller']",1,2013,mid,35000000,17616641,30926747,48543388,13543388
Hardflip,"Action,Drama",Action,['Drama'],6,2012,low,1000000,96734,0,96734,-903266
Penguins of Madagascar,"Adventure,Animation,Comedy",Adventure,"['Animation', 'Comedy']",11,2014,high,132000000,83350911,283591620,366942531,234942531
Magic Mike,"Comedy,Drama",Comedy,['Drama'],6,2012,mid,7000000,113721571,56828182,170549753,163549753
Bachelorette,"Comedy,Romance",Comedy,['Romance'],9,2012,low,3000000,446770,12130631,12577401,9577401
Pompeii,"Action,Adventure,Drama",Action,"['Adventure', 'Drama']",2,2014,high,80000000,23169033,85300000,108469033,28469033
Glee: The 3D Concert Movie,"Documentary,Music",Documentary,['Music'],8,2011,mid,9000000,11862398,5600000,17462398,8462398
Open Road,"Action,Drama,Thriller",Action,"['Drama', 'Thriller']",5,2013,low,3000000,0,47469,47469,-2952531
The Big Wedding,"Comedy,Drama,Romance",Comedy,"['Drama', 'Romance']",4,2013,mid,32500000,21819348,26606623,48425971,15925971
Seven Psychopaths,"Comedy,Crime",Comedy,['Crime'],10,2012,mid,13500000,15024049,18011687,33035736,19535736
Venom,Thriller,Thriller,[],10,2018,high,116000000,213511408,640117197,853628605,737628605
The Brass Teapot,"Comedy,Fantasy,Thriller",Comedy,"['Fantasy', 'Thriller']",4,2013,low,900000,6997,406736,413733,-486267
Carrie,"Drama,Horror",Drama,['Horror'],10,2013,mid,30000000,35266619,47142901,82409520,52409520
UglyDolls,"Adventure,Animation,Comedy",Adventure,"['Animation', 'Comedy']",5,2019,mid,45000000,19894664,4750000,24644664,-20355336
Drunk Wedding,Comedy,Comedy,[],5,2015,low,600000,3301,0,3301,-596699
The Hunger Games: Catching Fire,"Action,Adventure,Sci-Fi",Action,"['Adventure', 'Sci-Fi']",11,2013,high,130000000,424668047,440200000,864868047,734868047
The Hunger Games: Mockingjay - Part 1,"Action,Adventure,Sci-Fi",Action,"['Adventure', 'Sci-Fi']",11,2014,high,125000000,337135885,429439246,766575131,641575131
The Hunger Games: Mockingjay - Part 2,"Action,Adventure,Sci-Fi",Action,"['Adventure', 'Sci-Fi']",11,2015,high,160000000,281723902,367262885,648986787,488986787
Sex Tape,"Comedy,Romance",Comedy,['Romance'],7,2014,mid,40000000,38543473,87526036,126069509,86069509
American Assassin,"Action,Thriller",Action,['Thriller'],9,2017,high,63000000,36249674,32060466,68310140,5310140
Labor Day,"Drama,Romance",Drama,['Romance'],1,2014,mid,18000000,13371528,818282,14189810,-3810190
The Comedian,Comedy,Comedy,[],2,2017,mid,15000000,1658706,0,1658706,-13341294
Compliance,"Biography,Crime,Drama",Biography,"['Crime', 'Drama']",8,2012,low,270000,319285,511415,830700,560700
A Most Wanted Man,"Crime,Drama,Thriller",Crime,"['Drama', 'Thriller']",7,2014,mid,15000000,17237855,18831035,36068890,21068890
King Arthur: Legend of the Sword,"Action,Adventure,Drama",Action,"['Adventure', 'Drama']",5,2017,high,175000000,39175066,100455270,139630336,-35369664
The Best of Me,"Drama,Romance",Drama,['Romance'],10,2014,mid,26000000,26766213,14293205,41059418,15059418
The Neon Demon,"Horror,Thriller",Horror,['Thriller'],6,2016,mid,7500000,1333124,2226679,3559803,-3940197
Victor Frankenstein,"Drama,Horror,Sci-Fi",Drama,"['Horror', 'Sci-Fi']",11,2015,mid,40000000,5775076,25349291,31124367,-8875633
Sholem Aleichem: Laughing in the Darkness,Documentary,Documentary,[],7,2011,low,500000,1131261,0,1131261,631261
The Good Dinosaur,"Adventure,Animation,Comedy",Adventure,"['Animation', 'Comedy']",11,2015,high,187500000,123087120,210683917,333771037,146271037
Pain & Gain,"Action,Comedy,Crime",Action,"['Comedy', 'Crime']",4,2013,mid,26000000,49875291,31400000,81275291,55275291
Begin Again,"Comedy,Drama,Music",Comedy,"['Drama', 'Music']",6,2014,mid,8000000,16170632,52668104,68838736,60838736
The Young and Prodigious T.S. Spivet,"Action,Adventure,Comedy",Action,"['Adventure', 'Comedy']",7,2015,mid,33000000,176847,180840,357687,-32642313
Thor: The Dark World,"Action,Adventure,Fantasy",Action,"['Adventure', 'Fantasy']",11,2013,high,150000000,206362140,438240376,644602516,494602516
Geostorm,"Action,Sci-Fi,Thriller",Action,"['Sci-Fi', 'Thriller']",10,2017,high,100000000,33700160,187095849,220796009,120796009
Pitch Perfect,"Comedy,Music,Romance",Comedy,"['Music', 'Romance']",9,2012,mid,17000000,65001093,51043254,116044347,99044347
The Harvest/La Cosecha,Documentary,Documentary,[],7,2011,low,560000,3709,0,3709,-556291
The Angry Birds Movie,"Action,Animation,Comedy",Action,"['Animation', 'Comedy']",5,2016,high,73000000,107509366,244818521,352327887,279327887
Cloudy with a Chance of Meatballs 2,"Adventure,Animation,Comedy",Adventure,"['Animation', 'Comedy']",9,2013,high,78000000,119793567,154599082,274392649,196392649
The Upside,"Comedy,Drama",Comedy,['Drama'],1,2019,mid,37500000,108235497,10789039,119024536,81524536
Robot & Frank,"Comedy,Crime,Drama",Comedy,"['Crime', 'Drama']",8,2012,low,2500000,3317468,1616888,4934356,2434356
Chernobyl Diaries,"Horror,Mystery,Thriller",Horror,"['Mystery', 'Thriller']",5,2012,low,1000000,18119640,24292081,42411721,41411721
Kevin Hart: Laugh at My Pain,"Comedy,Documentary",Comedy,['Documentary'],9,2011,low,750000,7706436,6000,7712436,6962436
Hell Fest,Horror,Horror,[],9,2018,mid,5500000,11107431,7011800,18119231,12619231
Machete Kills,"Action,Crime,Sci-Fi",Action,"['Crime', 'Sci-Fi']",10,2013,mid,20000000,8008161,10264848,18273009,-1726991
War Dogs,"Comedy,Crime,Drama",Comedy,"['Crime', 'Drama']",8,2016,high,50000000,43034523,43199980,86234503,36234503
The Frozen Ground,"Crime,Drama,Mystery",Crime,"['Drama', 'Mystery']",8,2013,mid,19200000,0,5617460,5617460,-13582540
The 33,"Biography,Drama,History",Biography,"['Drama', 'History']",11,2015,mid,25000000,12227722,16172993,28400715,3400715
No Good Deed,"Action,Crime,Drama",Action,"['Crime', 'Drama']",9,2014,mid,13200000,52543632,1779578,54323210,41123210
Banshee Chapter,"Horror,Sci-Fi,Thriller",Horror,"['Sci-Fi', 'Thriller']",1,2014,low,950000,0,78122,78122,-871878
Guardians of the Galaxy,"Action,Adventure,Comedy",Action,"['Adventure', 'Comedy']",8,2014,high,170000000,333172112,437695404,770867516,600867516
The Smurfs 2,"Adventure,Animation,Comedy",Adventure,"['Animation', 'Comedy']",7,2013,high,110000000,71017784,277529739,348547523,238547523
Closer to the Moon,"Comedy,Crime,Drama",Comedy,"['Crime', 'Drama']",4,2014,low,1500000,0,5396,5396,-1494604
The Kick,"Action,Sport",Action,['Sport'],12,2011,low,3500000,0,40622,40622,-3459378
Diary of a Wimpy Kid: Dog Days,"Comedy,Family",Comedy,['Family'],8,2012,mid,22000000,49008662,28221033,77229695,55229695
Identity Thief,"Adventure,Comedy,Crime",Adventure,"['Comedy', 'Crime']",2,2013,mid,35000000,134506920,40854658,175361578,140361578
Non-Stop,"Action,Mystery,Thriller",Action,"['Mystery', 'Thriller']",2,2014,high,50000000,91742160,130640895,222383055,172383055
12 Years a Slave,"Biography,Drama,History",Biography,"['Drama', 'History']",10,2013,mid,20000000,56671993,124353350,181025343,161025343
The Finest Hours,"Action,Drama,History",Action,"['Drama', 'History']",1,2016,high,70000000,27569558,21683203,49252761,-20747239
A Better Life,Drama,Drama,[],6,2011,mid,10000000,1759252,124999,1884251,-8115749
The Reluctant Fundamentalist,"Drama,Thriller",Drama,['Thriller'],4,2013,mid,15000000,528731,0,528731,-14471269
USS Indianapolis: Men of Courage,"Action,Drama,History",Action,"['Drama', 'History']",11,2016,mid,40000000,0,1663785,1663785,-38336215
The Last Exorcism Part II,"Drama,Horror,Thriller",Drama,"['Horror', 'Thriller']",3,2013,low,4000000,15179303,10269404,25448707,21448707
"Pink Ribbons, Inc.",Documentary,Documentary,[],6,2012,low,1200000,26608,0,26608,-1173392
Flatliners,"Drama,Horror,Mystery",Drama,"['Horror', 'Mystery']",9,2017,mid,20000000,16883115,28290623,45173738,25173738
Inside Llewyn Davis,"Drama,Music",Drama,['Music'],12,2013,mid,11000000,13248209,19695038,32943247,21943247
Alice in Wonderland,"Fantasy,Musical",Fantasy,['Musical'],3,2010,high,200000000,334191110,691300000,1025491110,825491110
Home Run,"Drama,Sport",Drama,['Sport'],4,2013,low,1200000,2859955,0,2859955,1659955
Water & Power,"Crime,Drama",Crime,['Drama'],5,2014,low,600000,42557,0,42557,-557443
Side Effects,"Crime,Drama,Mystery",Crime,"['Drama', 'Mystery']",2,2013,mid,30000000,32172757,34569381,66742138,36742138
Eye in the Sky,"Drama,Thriller,War",Drama,"['Thriller', 'War']",3,2016,mid,13000000,18704596,16698206,35402802,22402802
The Railway Man,"Biography,Drama,Romance",Biography,"['Drama', 'Romance']",4,2014,mid,18000000,4438438,19471772,23910210,5910210
Point Break,"Action,Crime,Sport",Action,"['Crime', 'Sport']",12,2015,high,100000000,28782481,97922110,126704591,26704591
13 Sins,"Horror,Thriller",Horror,['Thriller'],4,2014,low,4000000,9134,38418,47552,-3952448
Rocketman,"Biography,Drama,Music",Biography,"['Drama', 'Music']",5,2019,mid,41000000,57342725,51300000,108642725,67642725
Dangerous Liaisons,"Drama,Mystery,Romance",Drama,"['Mystery', 'Romance']",11,2012,mid,24200000,17000,10430579,10447579,-13752421
Holy Motors,"Drama,Fantasy",Drama,['Fantasy'],10,2012,low,4000000,641054,3589372,4230426,230426
Steve Jobs,"Biography,Drama",Biography,['Drama'],10,2015,mid,30000000,17766658,17812349,35579007,5579007
The Best Man Holiday,"Comedy,Drama",Comedy,['Drama'],11,2013,mid,17000000,70525195,2310515,72835710,55835710
Trouble with the Curve,"Drama,Sport",Drama,['Sport'],9,2012,high,60000000,35763137,12055776,47818913,-12181087
The Imitation Game,"Biography,Drama,Thriller",Biography,"['Drama', 'Thriller']",11,2014,mid,15000000,91125143,136615320,227740463,212740463
Captain Underpants: The First Epic Movie,"Action,Animation,Comedy",Action,"['Animation', 'Comedy']",6,2017,mid,38000000,73921000,52656874,126577874,88577874
Grace of Monaco,"Biography,Drama,Romance",Biography,"['Drama', 'Romance']",12,2015,mid,30000000,0,25199891,25199891,-4800109
Dumb and Dumber To,"Adventure,Comedy",Adventure,['Comedy'],11,2014,mid,40000000,86208010,70345582,156553592,116553592
"McFarland, USA","Biography,Drama,Sport",Biography,"['Drama', 'Sport']",2,2015,mid,17000000,44480275,1227649,45707924,28707924
A.C.O.R.N.S.: Operation Crackdown,"Animation,Comedy,Family",Animation,"['Comedy', 'Family']",11,2016,mid,8500000,0,1353287,1353287,-7146713
Antiviral,"Horror,Sci-Fi,Thriller",Horror,"['Sci-Fi', 'Thriller']",4,2013,low,3100000,0,123407,123407,-2976593
Dead Man Down,"Action,Crime,Drama",Action,"['Crime', 'Drama']",3,2013,mid,30000000,10895295,8704679,19599974,-10400026
Spring Breakers,"Comedy,Crime,Drama",Comedy,"['Crime', 'Drama']",3,2013,mid,5000000,14124286,17024965,31149251,26149251
Tammy,"Comedy,Romance",Comedy,['Romance'],7,2014,mid,20000000,84525432,11882223,96407655,76407655
Dawn of the Planet of the Apes,"Action,Adventure,Drama",Action,"['Adventure', 'Drama']",7,2014,high,170000000,208545589,502098977,710644566,540644566
Into the Storm,"Action,Adventure,Drama",Action,"['Adventure', 'Drama']",8,2014,high,50000000,47602194,102827177,150429371,100429371
Noah,"Drama,Thriller",Drama,['Thriller'],3,2014,high,130000000,101200044,251631021,352831065,222831065
Paranormal Activity 4,"Horror,Mystery,Thriller",Horror,"['Mystery', 'Thriller']",10,2012,mid,5000000,53900335,88917657,142817992,137817992
Transformers: Age of Extinction,"Action,Adventure,Sci-Fi",Action,"['Adventure', 'Sci-Fi']",6,2014,high,210000000,245439076,858600000,1104039076,894039076
Swelter,"Action,Crime,Drama",Action,"['Crime', 'Drama']",8,2014,mid,8000000,0,44197,44197,-7955803
Elsa & Fred,"Comedy,Drama,Romance",Comedy,"['Drama', 'Romance']",11,2014,mid,10000000,67657,130244,197901,-9802099
Hacksaw Ridge,"Biography,Drama,History",Biography,"['Drama', 'History']",11,2016,mid,40000000,67209615,101695067,168904682,128904682
Pixels,"Action,Comedy,Sci-Fi",Action,"['Comedy', 'Sci-Fi']",7,2015,high,90000000,78765986,165275818,244041804,154041804
Beasts of the Southern Wild,"Adventure,Drama,Fantasy",Adventure,"['Drama', 'Fantasy']",6,2012,low,1800000,12795746,10469386,23265132,21465132
Collide,"Action,Crime,Thriller",Action,"['Crime', 'Thriller']",2,2017,mid,29200000,2280004,3186694,5466698,-23733302
San Andreas,"Action,Adventure,Drama",Action,"['Adventure', 'Drama']",5,2015,high,110000000,155190832,301067707,456258539,346258539
Second Act,"Comedy,Drama,Romance",Comedy,"['Drama', 'Romance']",12,2018,mid,15700000,39282227,24006627,63288854,47588854
Jane Got a Gun,"Action,Drama,Western",Action,"['Drama', 'Western']",1,2016,mid,25000000,1513793,2257552,3771345,-21228655
Saving Mr. Banks,"Biography,Comedy,Drama",Biography,"['Comedy', 'Drama']",12,2013,mid,35000000,83299761,31662764,114962525,79962525
The Accountant,"Action,Crime,Drama",Action,"['Crime', 'Drama']",10,2016,mid,40000000,86260045,66702038,152962083,112962083
Two Night Stand,"Comedy,Romance",Comedy,['Romance'],9,2014,low,1600000,15600,852481,868081,-731919
Food Chains,Documentary,Documentary,[],11,2014,low,913000,0,176,176,-912824
Black November,"Action,Crime,Drama",Action,"['Crime', 'Drama']",1,2015,mid,7500000,0,32572,32572,-7467428
Khiladi 786,"Action,Comedy",Action,['Comedy'],12,2012,mid,5600000,385422,14298341,14683763,9083763
Bad Words,"Comedy,Drama",Comedy,['Drama'],3,2014,mid,10000000,7779614,63531,7843145,-2156855
Horrible Bosses 2,"Comedy,Crime",Comedy,['Crime'],11,2014,mid,40000000,54445357,51500000,105945357,65945357
St. Vincent,"Comedy,Drama",Comedy,['Drama'],10,2014,mid,13000000,44137712,10699522,54837234,41837234
The Foreigner,"Comedy,Romance",Comedy,['Romance'],10,2017,mid,35000000,34393507,106389853,140783360,105783360
3 Days to Kill,"Action,Drama,Thriller",Action,"['Drama', 'Thriller']",2,2014,mid,28000000,30697999,8261901,38959900,10959900
Metallica Through the Never,Music,Music,[],9,2013,mid,18000000,3419967,5662939,9082906,-8917094
Jab Tak Hai Jaan,"Drama,Romance",Drama,['Romance'],11,2012,mid,9200000,3047539,2759127,5806666,-3393334
As It Is in Heaven,Drama,Drama,[],7,2014,low,450000,13486,0,13486,-436514
The Monuments Men,"Comedy,Drama,History",Comedy,"['Drama', 'History']",2,2014,high,70000000,78031620,80671128,158702748,88702748
Yeh Jawaani Hai Deewani,"Comedy,Drama,Musical",Comedy,"['Drama', 'Musical']",5,2013,mid,8300000,3827466,47000000,50827466,42527466
American Sniper,"Action,Biography,Drama",Action,"['Biography', 'Drama']",12,2014,high,58000000,350126372,197200000,547326372,489326372
Jackie,"Comedy,Drama,Romance",Comedy,"['Drama', 'Romance']",12,2016,mid,9000000,13960394,22628118,36588512,27588512
Song One,"Drama,Music",Drama,['Music'],1,2015,mid,6000000,32251,404838,437089,-5562911
Earth to Echo,"Adventure,Family,Sci-Fi",Adventure,"['Family', 'Sci-Fi']",7,2014,mid,13000000,38934842,3239703,42174545,29174545
The Purge,"Horror,Thriller",Horror,['Thriller'],6,2013,low,3000000,64473115,26793466,91266581,88266581
Escape from Tomorrow,"Drama,Fantasy,Horror",Drama,"['Fantasy', 'Horror']",10,2013,low,650000,171962,0,171962,-478038
Grown Ups 2,Comedy,Comedy,[],7,2013,high,80000000,133668525,113355283,247023808,167023808
The Counselor,"Crime,Drama,Thriller",Crime,"['Drama', 'Thriller']",10,2013,mid,25000000,16973715,54035619,71009334,46009334
About Time,"Comedy,Drama,Fantasy",Comedy,"['Drama', 'Fantasy']",11,2013,mid,12000000,15323921,73985257,89309178,77309178
Run All Night,"Action,Drama,Thriller",Action,"['Drama', 'Thriller']",3,2015,high,50000000,26461644,40500000,66961644,16961644
The Other Woman,"Comedy,Romance",Comedy,['Romance'],4,2014,mid,40000000,83911193,111200000,195111193,155111193
Before Midnight,"Drama,Romance",Drama,['Romance'],5,2013,low,3000000,8110621,15141309,23251930,20251930
Katy Perry: Part of Me,"Documentary,Music",Documentary,['Music'],7,2012,mid,12000000,25326071,7374368,32700439,20700439
Now You See Me,"Drama,Horror,Thriller",Drama,"['Horror', 'Thriller']",5,2013,high,75000000,117723989,225045211,342769200,267769200
Draft Day,"Drama,Sport",Drama,['Sport'],4,2014,mid,25000000,28842237,1005243,29847480,4847480
Plush,"Drama,Music,Thriller",Drama,"['Music', 'Thriller']",9,2013,low,2000000,3080,25784,28864,-1971136
Don Jon,"Comedy,Drama,Romance",Comedy,"['Drama', 'Romance']",9,2013,mid,5500000,24477704,16790875,41268579,35768579
Wild Card,"Action,Crime,Drama",Action,"['Crime', 'Drama']",1,2015,mid,30000000,3200,4312589,4315789,-25684211
Rampage,"Action,Adventure,Sci-Fi",Action,"['Adventure', 'Sci-Fi']",4,2018,high,120000000,101028233,327028047,428056280,308056280
The Internship,Comedy,Comedy,[],6,2013,high,58000000,44672764,49000000,93672764,35672764
Dear White People,"Comedy,Drama,Romance",Comedy,"['Drama', 'Romance']",10,2014,low,1250000,4404154,999617,5403771,4153771
Valerian and the City of a Thousand Planets,"Action,Adventure,Fantasy",Action,"['Adventure', 'Fantasy']",7,2017,high,180000000,40479370,174618986,215098356,35098356
Think Like a Man Too,"Comedy,Romance",Comedy,['Romance'],6,2014,mid,24000000,65028687,4999246,70027933,46027933
Money Monster,"Crime,Drama,Thriller",Crime,"['Drama', 'Thriller']",5,2016,mid,27000000,41012075,52454020,93466095,66466095
A Haunted House,"Comedy,Fantasy",Comedy,['Fantasy'],1,2013,low,2500000,40041683,19880875,59922558,57422558
Big Hero 6,"Action,Adventure,Animation",Action,"['Adventure', 'Animation']",11,2014,high,165000000,222527828,429600000,652127828,487127828
Born to Fly: Elizabeth Streb vs. Gravity,"Action,Biography,Documentary",Action,"['Biography', 'Documentary']",9,2014,low,500000,1822,0,1822,-498178
When the Game Stands Tall,"Drama,Family,Sport",Drama,"['Family', 'Sport']",8,2014,mid,15000000,30127963,10949,30138912,15138912
Zulu,"Crime,Drama,Thriller",Crime,"['Drama', 'Thriller']",12,2013,mid,16000000,0,1844228,1844228,-14155772
Spider-Man: Homecoming,"Action,Adventure,Sci-Fi",Action,"['Adventure', 'Sci-Fi']",7,2017,high,175000000,334201140,545965210,880166350,705166350
Ride Along,Action,Action,[],1,2014,mid,25000000,134202565,19531235,153733800,128733800
Drinking Buddies,"Comedy,Drama,Romance",Comedy,"['Drama', 'Romance']",8,2013,low,500000,343706,63394,407100,-92900
Kung Fu Panda 3,"Action,Adventure,Animation",Action,"['Adventure', 'Animation']",1,2016,high,140000000,143528619,374070523,517599142,377599142
Gone Girl,"Drama,Mystery,Thriller",Drama,"['Mystery', 'Thriller']",10,2014,high,61000000,167767189,200800000,368567189,307567189
Magic Mike XXL,"Comedy,Drama,Music",Comedy,"['Drama', 'Music']",7,2015,mid,14500000,66013057,57647540,123660597,109160597
Hellboy,"Action,Adventure,Fantasy",Action,"['Adventure', 'Fantasy']",4,2019,high,50000000,21903748,18821744,40725492,-9274508
Finding Dory,"Adventure,Animation,Comedy",Adventure,"['Animation', 'Comedy']",6,2016,high,200000000,486295561,534919632,1021215193,821215193
The Grand Budapest Hotel,"Adventure,Comedy,Crime",Adventure,"['Comedy', 'Crime']",3,2014,mid,31000000,59076019,104905242,163981261,132981261
Love the Coopers,"Comedy,Fantasy,Romance",Comedy,"['Fantasy', 'Romance']",11,2015,mid,18000000,26302731,15924759,42227490,24227490
The SpongeBob Movie: Sponge Out of Water,"Adventure,Animation,Comedy",Adventure,"['Animation', 'Comedy']",2,2015,high,74000000,162994032,148019149,311013181,237013181
Muppets Most Wanted,"Adventure,Comedy,Crime",Adventure,"['Comedy', 'Crime']",3,2014,high,55000000,51178893,28133408,79312301,24312301
Men in Black: International,"Action,Adventure,Comedy",Action,"['Adventure', 'Comedy']",6,2019,high,110000000,3100000,0,3100000,-106900000
Jumanji: Welcome to the Jungle,"Action,Adventure,Comedy",Action,"['Adventure', 'Comedy']",12,2017,high,90000000,404508916,559987277,964496193,874496193
Along the Roadside,"Comedy,Music,Romance",Comedy,"['Music', 'Romance']",3,2015,low,250000,0,3234,3234,-246766
The Canyons,"Drama,Thriller",Drama,['Thriller'],8,2013,low,250000,59671,2704,62375,-187625
Minions,"Adventure,Animation,Comedy",Adventure,"['Animation', 'Comedy']",7,2015,high,74000000,336045770,824290403,1160336173,1086336173
22 Jump Street,"Action,Comedy,Crime",Action,"['Comedy', 'Crime']",6,2014,high,50000000,191719337,139614539,331333876,281333876
Frozen,"Adventure,Animation,Comedy",Adventure,"['Animation', 'Comedy']",11,2013,high,150000000,400738009,871731901,1272469910,1122469910
Falcon Rising,"Action,Adventure",Action,['Adventure'],9,2014,low,4500000,11774,0,11774,-4488226
Sherlock Gnomes,"Adventure,Animation,Comedy",Adventure,"['Animation', 'Comedy']",3,2018,high,59000000,43242871,44284780,87527651,28527651
Olympus Has Fallen,"Action,Thriller",Action,['Thriller'],3,2013,high,70000000,98927592,73951336,172878928,102878928
23 Blast,"Drama,Family,Sport",Drama,"['Family', 'Sport']",10,2014,low,1000000,549185,0,549185,-450815
Mandela: Long Walk to Freedom,"Biography,Drama,History",Biography,"['Drama', 'History']",11,2013,mid,35000000,8323085,21567317,29890402,-5109598
The 5th Wave,"Action,Adventure,Drama",Action,"['Adventure', 'Drama']",1,2016,mid,38000000,34912982,76423416,111336398,73336398
The Gallows,"Horror,Mystery,Thriller",Horror,"['Mystery', 'Thriller']",7,2015,low,100000,22764410,18892064,41656474,41556474
The Gatekeepers,"Documentary,History,War",Documentary,"['History', 'War']",2,2013,low,1500000,2408553,183755,2592308,1092308
The Hobbit: The Battle of the Five Armies,"Adventure,Fantasy",Adventure,['Fantasy'],12,2014,high,250000000,255119788,690457833,945577621,695577621
Windsor Drive,"Mystery,Thriller",Mystery,['Thriller'],8,2015,low,850000,3256,0,3256,-846744
Alien: Covenant,"Horror,Sci-Fi,Thriller",Horror,"['Sci-Fi', 'Thriller']",5,2017,high,97000000,74262031,164259216,238521247,141521247
Endless Love,"Drama,Romance",Drama,['Romance'],2,2014,mid,20000000,23438250,11279923,34718173,14718173
ABCD (Any Body Can Dance),"Drama,Music",Drama,['Music'],2,2013,low,1900000,222098,9915136,10137234,8237234
The Babadook,"Drama,Horror",Drama,['Horror'],11,2014,low,2000000,950792,6531595,7482387,5482387
Fifty Shades of Grey,"Drama,Romance,Thriller",Drama,"['Romance', 'Thriller']",2,2015,mid,40000000,166167230,404830871,570998101,530998101
Strangerland,"Drama,Mystery,Thriller",Drama,"['Mystery', 'Thriller']",7,2015,mid,10000000,17472,143625,161097,-9838903
Mary Queen of Scots,"Biography,Drama,History",Biography,"['Drama', 'History']",12,2018,mid,25000000,16468499,30266234,46734733,21734733
No Escape,"Documentary,Music",Documentary,['Music'],8,2015,mid,5000000,27288872,15555644,42844516,37844516
The Expendables 3,"Action,Adventure,Thriller",Action,"['Adventure', 'Thriller']",8,2014,high,100000000,39322544,170138834,209461378,109461378
Fruitvale Station,"Biography,Drama,Romance",Biography,"['Drama', 'Romance']",7,2013,low,900000,16098998,1450647,17549645,16649645
Blue Jasmine,Drama,Drama,[],7,2013,mid,18000000,33404871,69508090,102912961,84912961
White House Down,"Action,Drama,Thriller",Action,"['Drama', 'Thriller']",6,2013,high,150000000,73103784,132336603,205440387,55440387
Parkland,"Drama,History,Mystery",Drama,"['History', 'Mystery']",10,2013,mid,10000000,641439,974914,1616353,-8383647
The Rover,"Action,Crime,Drama",Action,"['Crime', 'Drama']",6,2014,mid,8500000,1109199,2071053,3180252,-5319748
The Mummy,"Action,Adventure,Fantasy",Action,"['Adventure', 'Fantasy']",6,2017,high,195000000,80101125,329852780,409953905,214953905
Frances Ha,"Comedy,Drama,Romance",Comedy,"['Drama', 'Romance']",5,2013,low,3000000,4067398,7195371,11262769,8262769
Grace Unplugged,"Drama,Music",Drama,['Music'],10,2013,low,1700000,2507159,0,2507159,807159
The Lunchbox,"Drama,Romance",Drama,['Romance'],2,2014,low,1700000,4231500,8000000,12231500,10531500
Stone,"Action,Sci-Fi",Action,['Sci-Fi'],10,2010,mid,22000000,1810078,2254942,4065020,-17934980
Jobs,"Biography,Drama",Biography,['Drama'],8,2013,mid,18000000,16131410,27271105,43402515,25402515
Rio 2,"Adventure,Animation,Comedy",Adventure,"['Animation', 'Comedy']",4,2014,high,130000000,131538435,361307856,492846291,362846291
Blue Ruin,"Crime,Drama,Thriller",Crime,"['Drama', 'Thriller']",4,2014,low,420000,258384,178618,437002,17002
Live by Night,"Action,Crime,Drama",Action,"['Crime', 'Drama']",12,2016,high,65000000,10378555,11395877,21774432,-43225568
The Intern,"Comedy,Drama",Comedy,['Drama'],9,2015,mid,40000000,75764672,121351038,197115710,157115710
Antarctica: A Year on Ice,"Adventure,Biography,Documentary",Adventure,"['Biography', 'Documentary']",11,2014,low,1000000,288757,0,288757,-711243
Runner Runner,"Crime,Thriller",Crime,['Thriller'],10,2013,mid,30000000,19316646,41196034,60512680,30512680
The Disappointments Room,"Drama,Horror,Thriller",Drama,"['Horror', 'Thriller']",9,2016,mid,15000000,2423467,1080294,3503761,-11496239
Lost River,"Drama,Fantasy,Mystery",Drama,"['Fantasy', 'Mystery']",4,2015,low,2000000,45431,1964213,2009644,9644
Need for Speed,"Action,Crime,Thriller",Action,"['Crime', 'Thriller']",3,2014,high,66000000,43568507,150601112,194169619,128169619
The Act of Killing,"Crime,Documentary",Crime,['Documentary'],7,2013,low,1000000,486919,740397,1227316,227316
Deliver Us from Evil,"Horror,Mystery,Thriller",Horror,"['Mystery', 'Thriller']",7,2014,mid,30000000,30577122,57379496,87956618,57956618
Spectre,"Action,Adventure,Thriller",Action,"['Adventure', 'Thriller']",11,2015,high,300000000,200074175,679546748,879620923,579620923
How to Train Your Dragon: The Hidden World,"Action,Adventure,Animation",Action,"['Adventure', 'Animation']",2,2019,high,129000000,160791800,358466483,519258283,390258283
Dark Skies,"Horror,Sci-Fi,Thriller",Horror,"['Sci-Fi', 'Thriller']",2,2013,low,3500000,17418667,10285444,27704111,24204111
Delivery Man,"Comedy,Drama",Comedy,['Drama'],11,2013,mid,22000000,30659817,39877053,70536870,48536870
Flipped,"Drama,Thriller",Drama,['Thriller'],8,2010,mid,14000000,1755212,2534781,4289993,-9710007
Ain't Them Bodies Saints,"Crime,Drama,Romance",Crime,"['Drama', 'Romance']",8,2013,mid,5000000,391611,683398,1075009,-3924991
Oculus,"Horror,Mystery",Horror,['Mystery'],4,2014,mid,5000000,27695246,16420250,44115496,39115496
Cheap Thrills,"Comedy,Crime,Drama",Comedy,"['Crime', 'Drama']",3,2014,low,100000,59424,0,59424,-40576
Enough Said,"Comedy,Drama,Romance",Comedy,"['Drama', 'Romance']",9,2013,mid,8000000,17550872,8070577,25621449,17621449
Kursk,Drama,Drama,[],6,2019,mid,40000000,0,4212799,4212799,-35787201
Avengers: Age of Ultron,"Action,Adventure,Sci-Fi",Action,"['Adventure', 'Sci-Fi']",5,2015,high,330600000,459005868,944008095,1403013963,1072413963
The Homesman,"Drama,Western",Drama,['Western'],11,2014,mid,16000000,2429989,5787582,8217571,-7782429
Smurfs: The Lost Village,"Adventure,Animation,Comedy",Adventure,"['Animation', 'Comedy']",4,2017,high,60000000,45020282,152558304,197578586,137578586
They Came Together,"Comedy,Romance",Comedy,['Romance'],6,2014,low,3000000,0,82780,82780,-2917220
Anomalisa,"Animation,Comedy,Drama",Animation,"['Comedy', 'Drama']",12,2015,mid,8000000,3759286,1946882,5706168,-2293832
Dom Hemingway,"Comedy,Crime,Drama",Comedy,"['Crime', 'Drama']",4,2014,mid,7000000,523511,1333947,1857458,-5142542
The November Man,"Action,Crime,Thriller",Action,"['Crime', 'Thriller']",8,2014,mid,15000000,25018119,9802216,34820335,19820335
Carol,"Drama,Romance",Drama,['Romance'],11,2015,mid,11800000,12711491,30132030,42843521,31043521
The Green Inferno,"Adventure,Horror",Adventure,['Horror'],9,2015,low,1000000,7192291,5739129,12931420,11931420
Desert Dancer,"Biography,Drama,Music",Biography,"['Drama', 'Music']",4,2015,low,4000000,155271,441064,596335,-3403665
Gods of Egypt,"Action,Adventure,Fantasy",Action,"['Adventure', 'Fantasy']",2,2016,high,140000000,31153464,107683292,138836756,-1163244
Woman in Gold,"Biography,Drama,History",Biography,"['Drama', 'History']",4,2015,mid,11000000,33307793,25278614,58586407,47586407
The Magnificent Seven,"Action,Adventure,Western",Action,"['Adventure', 'Western']",9,2016,high,90000000,93432655,69092501,162525156,72525156
The Heat,"Action,Comedy,Crime",Action,"['Comedy', 'Crime']",6,2013,mid,43000000,159581587,70146187,229727774,186727774
Atomic Blonde,"Action,Mystery,Thriller",Action,"['Mystery', 'Thriller']",7,2017,mid,30000000,51573925,46771498,98345423,68345423
Killers,"Action,Crime,Drama",Action,"['Crime', 'Drama']",6,2010,high,75000000,47059963,48512786,95572749,20572749
The Campaign,Documentary,Documentary,[],8,2012,high,95000000,86907746,18000000,104907746,9907746
Butterfly Girl,Documentary,Documentary,[],2,2015,low,180000,17503,0,17503,-162497
Philomena,"Biography,Comedy,Drama",Biography,"['Comedy', 'Drama']",11,2013,mid,12000000,37709979,61253413,98963392,86963392
Project Almanac,"Drama,Mystery,Sci-Fi",Drama,"['Mystery', 'Sci-Fi']",1,2015,mid,12000000,22348241,10561196,32909437,20909437
Taken 3,"Action,Thriller",Action,['Thriller'],1,2015,mid,48000000,89256424,238400000,327656424,279656424
The Peanuts Movie,"Adventure,Animation,Comedy",Adventure,"['Animation', 'Comedy']",11,2015,high,99000000,130178411,119913199,250091610,151091610
Mi America,"Crime,Drama",Crime,['Drama'],10,2016,low,2100000,3330,0,3330,-2096670
And So It Goes,"Comedy,Drama,Romance",Comedy,"['Drama', 'Romance']",7,2014,mid,18000000,15160801,2759212,17920013,-79987
Paranormal Activity: The Ghost Dimension,"Horror,Mystery,Thriller",Horror,"['Mystery', 'Thriller']",10,2015,mid,10000000,18297124,59662250,77959374,67959374
Get on Up,"Biography,Drama,Music",Biography,"['Drama', 'Music']",8,2014,mid,30000000,30569935,2769933,33339868,3339868
Paranormal Activity: The Marked Ones,"Horror,Mystery,Thriller",Horror,"['Mystery', 'Thriller']",1,2014,mid,5000000,32462372,58442482,90904854,85904854
Mr. Turner,"Biography,Drama,History",Biography,"['Drama', 'History']",12,2014,mid,14000000,3958546,21228480,25187026,11187026
The Last Five Years,"Comedy,Drama,Musical",Comedy,"['Drama', 'Musical']",2,2015,low,2000000,147299,57999,205298,-1794702
Palo Alto,Drama,Drama,[],5,2014,low,1000000,767732,388577,1156309,156309
Bone Tomahawk,"Adventure,Drama,Horror",Adventure,"['Drama', 'Horror']",10,2015,low,2000000,0,475846,475846,-1524154
Aloft,Drama,Drama,[],5,2015,mid,8000000,53086,184602,237688,-7762312
Speak No Evil,Horror,Horror,[],12,2013,low,150000,0,32927,32927,-117073
Broken Horses,"Action,Crime,Drama",Action,"['Crime', 'Drama']",9,2015,mid,15000000,0,3471,3471,-14996529
Hotel Transylvania 2,"Animation,Comedy,Family",Animation,"['Comedy', 'Family']",9,2015,high,80000000,169700110,299800188,469500298,389500298
Mud,Drama,Drama,[],4,2013,mid,10000000,21590086,9966873,31556959,21556959
Escobar: Paradise Lost,"Crime,Drama,History",Crime,"['Drama', 'History']",6,2015,mid,17000000,195792,3721887,3917679,-13082321
Blockers,Comedy,Comedy,[],4,2018,mid,21000000,60311495,33733833,94045328,73045328
Wonder,"Drama,Family",Drama,['Family'],11,2017,mid,20000000,132422809,172181903,304604712,284604712
The Light Between Oceans,"Drama,Romance",Drama,['Romance'],9,2016,mid,20000000,12545979,9735753,22281732,2281732
"Cinco de Mayo, La Batalla","Drama,History,War",Drama,"['History', 'War']",5,2013,mid,10000000,173472,0,173472,-9826528
Crimson Peak,"Drama,Fantasy,Horror",Drama,"['Fantasy', 'Horror']",10,2015,high,55000000,31090320,43876534,74966854,19966854
The Second Best Exotic Marigold Hotel,"Comedy,Drama",Comedy,['Drama'],3,2015,mid,10000000,33078266,57306040,90384306,80384306
Plastic,"Action,Comedy,Crime",Action,"['Comedy', 'Crime']",9,2014,mid,10000000,0,575371,575371,-9424629
Pacific Rim: Uprising,"Action,Adventure,Sci-Fi",Action,"['Adventure', 'Sci-Fi']",3,2018,high,155000000,59874525,231055623,290930148,135930148
Homefront,Drama,Drama,[],11,2013,mid,22000000,20158492,31536870,51695362,29695362
Ballerina,"Biography,Documentary",Biography,['Documentary'],8,2017,mid,30000000,21858070,75034759,96892829,66892829
Birdman or (The Unexpected Virtue of Ignorance),"Comedy,Drama",Comedy,['Drama'],10,2014,mid,18000000,42340598,60874496,103215094,85215094
Alice Through the Looking Glass,"Adventure,Family,Fantasy",Adventure,"['Family', 'Fantasy']",5,2016,high,170000000,77042381,199885731,276928112,106928112
Going in Style,"Comedy,Crime",Comedy,['Crime'],4,2017,mid,24000000,45018541,33654038,78672579,54672579
Me and Earl and the Dying Girl,"Comedy,Drama,Romance",Comedy,"['Drama', 'Romance']",6,2015,mid,8000000,6758416,2507764,9266180,1266180
Shut In,"Drama,Mystery,Thriller",Drama,"['Mystery', 'Thriller']",11,2016,mid,10000000,6900335,4460330,11360665,1360665
Hell or High Water,"Action,Crime,Drama",Action,"['Crime', 'Drama']",8,2016,mid,12000000,27007844,10576460,37584304,25584304
Whiplash,"Drama,Music",Drama,['Music'],10,2014,low,3300000,13092006,25877031,38969037,35669037
The Fault in Our Stars,"Drama,Romance",Drama,['Romance'],6,2014,mid,12000000,124872350,182294484,307166834,295166834
Resident Evil: The Final Chapter,"Action,Horror,Sci-Fi",Action,"['Horror', 'Sci-Fi']",1,2017,mid,40000000,26844692,287256498,314101190,274101190
Kevin Hart: Let Me Explain,"Comedy,Documentary",Comedy,['Documentary'],7,2013,low,2500000,32244051,83204,32327255,29827255
Pump,Documentary,Documentary,[],9,2014,low,2000000,72277,0,72277,-1927723
Baahubali: The Beginning,"Action,Drama",Action,['Drama'],7,2015,mid,40000000,6738000,19998665,26736665,-13263335
Ted 2,Comedy,Comedy,[],6,2015,high,68000000,81476385,135737758,217214143,149214143
Hot Tub Time Machine 2,"Comedy,Mystery,Sci-Fi",Comedy,"['Mystery', 'Sci-Fi']",2,2015,mid,14000000,12314651,511993,12826644,-1173356
Ben-Hur,"Action,Adventure,Drama",Action,"['Adventure', 'Drama']",8,2016,high,95000000,26410477,65259171,91669648,-3330352
Midnight Special,"Action,Drama,Mystery",Action,"['Drama', 'Mystery']",3,2016,mid,18000000,3712282,3967968,7680250,-10319750
Deceptive Practice: The Mysteries and Mentors of Ricky Jay,Documentary,Documentary,[],4,2013,low,500000,152449,0,152449,-347551
Star Trek Beyond,"Action,Adventure,Sci-Fi",Action,"['Adventure', 'Sci-Fi']",7,2016,high,185000000,158848340,176953893,335802233,150802233
Miss Julie,"Drama,Romance",Drama,['Romance'],5,2015,mid,5500000,0,863895,863895,-4636105
Me Before You,"Drama,Romance",Drama,['Romance'],6,2016,mid,20000000,56245075,152020123,208265198,188265198
Hitman: Agent 47,"Action,Adventure,Crime",Action,"['Adventure', 'Crime']",8,2015,mid,35000000,22467450,59715353,82182803,47182803
The D Train,"Comedy,Drama",Comedy,['Drama'],5,2015,low,3000000,669688,102678,772366,-2227634
Night at the Museum: Secret of the Tomb,"Adventure,Comedy,Family",Adventure,"['Comedy', 'Family']",12,2014,high,127000000,113746621,240010000,353756621,226756621
Locke,Drama,Drama,[],4,2014,low,2000000,1370646,717744,2088390,88390
The Debt,"Drama,Mystery,Thriller",Drama,"['Mystery', 'Thriller']",8,2011,mid,20000000,31177548,15426506,46604054,26604054
Long Shot,"Biography,Documentary",Biography,['Documentary'],5,2019,mid,40000000,30202860,13508171,43711031,3711031
The Boss,Comedy,Comedy,[],4,2016,mid,29000000,63077560,15574647,78652207,49652207
Game Night,"Action,Comedy,Crime",Action,"['Comedy', 'Crime']",2,2018,mid,37000000,69179066,48199018,117378084,80378084
The Secret Life of Pets,"Adventure,Animation,Comedy",Adventure,"['Animation', 'Comedy']",7,2016,high,75000000,368384330,518366204,886750534,811750534
Fury,"Action,Drama,War",Action,"['Drama', 'War']",10,2014,high,80000000,85817906,124497775,210315681,130315681
Blackhat,"Action,Crime,Thriller",Action,"['Crime', 'Thriller']",1,2015,high,70000000,8005980,11659024,19665004,-50334996
Ida,Drama,Drama,[],5,2014,low,2600000,3827060,11471295,15298355,12698355
Everest,"Action,Adventure,Biography",Action,"['Adventure', 'Biography']",9,2015,high,65000000,43482270,177814791,221297061,156297061
Birth of the Dragon,"Action,Biography,Drama",Action,"['Biography', 'Drama']",8,2017,mid,31000000,6901965,318525,7220490,-23779510
Jungle Shuffle,"Adventure,Animation",Adventure,['Animation'],3,2015,mid,10000000,0,360898,360898,-9639102
The Sleepwalker,Drama,Drama,[],11,2014,low,1100000,2636,0,2636,-1097364
The Longest Ride,"Drama,Romance",Drama,['Romance'],4,2015,mid,34000000,37446117,26356811,63802928,29802928
The Christmas Candle,"Drama,Family",Drama,['Family'],11,2013,mid,7000000,1632000,301829,1933829,-5066171
Rosewater,"Biography,Drama",Biography,['Drama'],11,2014,mid,10000000,3128941,56776,3185717,-6814283
Devil's Due,"Horror,Mystery,Thriller",Horror,"['Mystery', 'Thriller']",1,2014,mid,7000000,15821461,20324626,36146087,29146087
Sinister 2,"Horror,Mystery,Thriller",Horror,"['Mystery', 'Thriller']",8,2015,mid,10000000,27740955,26363270,54104225,44104225
Faith Connections,"Biography,Documentary,Drama",Biography,"['Documentary', 'Drama']",9,2014,low,550000,9111,0,9111,-540889
Veronica Mars,"Crime,Drama,Mystery",Crime,"['Drama', 'Mystery']",3,2014,mid,6000000,3322127,163256,3485383,-2514617
Thank You for Your Service,"Biography,Drama,War",Biography,"['Drama', 'War']",10,2017,mid,20000000,9479390,505926,9985316,-10014684
Top Five,"Comedy,Romance",Comedy,['Romance'],12,2014,mid,12000000,25317379,684362,26001741,14001741
The Opposite Sex,Comedy,Comedy,[],1,2015,low,3300000,0,50206,50206,-3249794
Annihilation,"Adventure,Drama,Horror",Adventure,"['Drama', 'Horror']",2,2018,high,55000000,32732301,10338614,43070915,-11929085
Atlas Shrugged: Who Is John Galt?,"Drama,Mystery,Sci-Fi",Drama,"['Mystery', 'Sci-Fi']",9,2014,mid,5000000,851690,0,851690,-4148310
Kingsman: The Secret Service,"Action,Adventure,Comedy",Action,"['Adventure', 'Comedy']",2,2015,high,94000000,128261724,276300000,404561724,310561724
United Passions,"Drama,History,Sport",Drama,"['History', 'Sport']",6,2015,mid,30000000,918,167914,168832,-29831168
Furious 7,"Action,Crime,Thriller",Action,"['Crime', 'Thriller']",4,2015,high,190000000,353007020,1165715774,1518722794,1328722794
Rock Dog,"Adventure,Animation,Comedy",Adventure,"['Animation', 'Comedy']",2,2017,high,60000000,9420546,14727942,24148488,-35851512
Mike and Dave Need Wedding Dates,"Adventure,Comedy,Romance",Adventure,"['Comedy', 'Romance']",7,2016,mid,33000000,46009673,29888427,75898100,42898100
A Haunted House 2,"Comedy,Fantasy",Comedy,['Fantasy'],4,2014,low,4000000,17329487,3877374,21206861,17206861
Pitch Perfect 2,"Comedy,Music",Comedy,['Music'],5,2015,mid,29000000,184296230,103329238,287625468,258625468
Heli,"Crime,Drama,Romance",Crime,"['Drama', 'Romance']",12,2013,low,1000000,0,552614,552614,-447386
Ride Along 2,"Action,Comedy,Crime",Action,"['Comedy', 'Crime']",1,2016,mid,40000000,90862685,33964631,124827316,84827316
Wish I Was Here,"Comedy,Drama",Comedy,['Drama'],7,2014,mid,6000000,3591299,3000066,6591365,591365
Nightcrawler,"Crime,Drama,Thriller",Crime,"['Drama', 'Thriller']",10,2014,mid,8500000,32381218,17953200,50334418,41834418
Red Sparrow,"Action,Drama,Thriller",Action,"['Drama', 'Thriller']",3,2018,high,69000000,46874505,99077356,145951861,76951861
I Origins,"Drama,Romance,Sci-Fi",Drama,"['Romance', 'Sci-Fi']",7,2014,low,1000000,336472,515927,852399,-147601
Manglehorn,Drama,Drama,[],6,2015,low,4000000,132270,665169,797439,-3202561
Obvious Child,"Comedy,Drama,Romance",Comedy,"['Drama', 'Romance']",6,2014,low,1000000,3122616,201454,3324070,2324070
The Signal,"Drama,Mystery,Sci-Fi",Drama,"['Mystery', 'Sci-Fi']",6,2014,low,4000000,600896,2064426,2665322,-1334678
The Dressmaker,"Comedy,Drama",Comedy,['Drama'],9,2016,mid,11900000,2022115,22019502,24041617,12141617
John Wick,"Action,Crime,Thriller",Action,"['Crime', 'Thriller']",10,2014,mid,30000000,43037835,33197166,76235001,46235001
The Looking Glass,"Drama,Music",Drama,['Music'],10,2015,low,300000,1711,0,1711,-298289
R100,"Comedy,Drama",Comedy,['Drama'],1,2015,mid,5500000,24956,0,24956,-5475044
The Lazarus Effect,"Horror,Mystery,Sci-Fi",Horror,"['Mystery', 'Sci-Fi']",2,2015,mid,5000000,25801570,12557740,38359310,33359310
American Heist,"Action,Crime,Drama",Action,"['Crime', 'Drama']",7,2015,mid,10000000,0,2341218,2341218,-7658782
Higher Power,"Action,Sci-Fi,Thriller",Action,"['Sci-Fi', 'Thriller']",5,2018,low,500000,528,0,528,-499472
Father Figures,Documentary,Documentary,[],12,2017,mid,25000000,17501244,3537197,21038441,-3961559
A Most Violent Year,"Crime,Drama,Thriller",Crime,"['Drama', 'Thriller']",12,2014,mid,20000000,5749134,3097741,8846875,-11153125
The Transporter Refueled,"Action,Adventure,Crime",Action,"['Adventure', 'Crime']",9,2015,mid,22000000,16029670,53668825,69698495,47698495
Zootopia,"Adventure,Animation,Comedy",Adventure,"['Animation', 'Comedy']",3,2016,high,150000000,341268248,678161368,1019429616,869429616
Focus,Comedy,Comedy,[],2,2015,high,65000000,53862963,114202737,168065700,103065700
Greater,"Biography,Family,Sport",Biography,"['Family', 'Sport']",8,2016,mid,9000000,2000093,0,2000093,-6999907
Happy Christmas,"Comedy,Drama",Comedy,['Drama'],7,2014,low,70000,30312,0,30312,-39688
Hot Pursuit,"Action,Comedy,Crime",Action,"['Comedy', 'Crime']",5,2015,mid,35000000,34580201,11091311,45671512,10671512
Alvin and the Chipmunks: The Road Chip,"Adventure,Animation,Comedy",Adventure,"['Animation', 'Comedy']",12,2015,high,90000000,85886987,163630969,249517956,159517956
The Purge: Anarchy,"Action,Horror,Sci-Fi",Action,"['Horror', 'Sci-Fi']",7,2014,mid,9000000,71562550,39972331,111534881,102534881
Batman v Superman: Dawn of Justice,"Action,Adventure,Fantasy",Action,"['Adventure', 'Fantasy']",3,2016,high,250000000,330360194,537140087,867500281,617500281
Dolphin Tale 2,"Drama,Family",Drama,['Family'],9,2014,mid,36000000,42024533,15800000,57824533,21824533
A Hologram for the King,"Comedy,Drama,Romance",Comedy,"['Drama', 'Romance']",4,2016,mid,35000000,4212494,7633516,11846010,-23153990
The Theory of Everything,"Biography,Drama,Romance",Biography,"['Drama', 'Romance']",11,2014,mid,15000000,35893537,87434155,123327692,108327692
The Hundred-Foot Journey,"Comedy,Drama",Comedy,['Drama'],8,2014,mid,22000000,54235441,40035047,94270488,72270488
Camp X-Ray,"Drama,War",Drama,['War'],10,2014,low,1000000,9837,91216,101053,-898947
The Water Diviner,"Drama,History,War",Drama,"['History', 'War']",4,2015,mid,22500000,4200117,26854610,31054727,8554727
Shame,Drama,Drama,[],12,2011,mid,6500000,4002293,16410548,20412841,13912841
The Lego Ninjago Movie,"Action,Adventure,Animation",Action,"['Adventure', 'Animation']",9,2017,high,70000000,59281555,63455646,122737201,52737201
Criminal,"Action,Crime,Drama",Action,"['Crime', 'Drama']",4,2016,mid,31500000,14708696,24062566,38771262,7271262
The Jungle Book,"Adventure,Drama,Family",Adventure,"['Drama', 'Family']",4,2016,high,175000000,364001123,598853424,962854547,787854547
Mortdecai,"Action,Comedy,Crime",Action,"['Comedy', 'Crime']",1,2015,high,60000000,7696134,22700000,30396134,-29603866
Hardcore Henry,"Action,Adventure,Sci-Fi",Action,"['Adventure', 'Sci-Fi']",4,2016,low,2000000,9252038,7935396,17187434,15187434
The Past is a Grotesque Animal,"Biography,Documentary,Music",Biography,"['Documentary', 'Music']",6,2014,low,100000,20056,0,20056,-79944
Suffragette,"Biography,Drama,History",Biography,"['Drama', 'History']",10,2015,mid,14000000,4702420,29342489,34044909,20044909
Monster Trucks,"Action,Adventure,Comedy",Action,"['Adventure', 'Comedy']",1,2017,high,125000000,33370166,28272632,61642798,-63357202
Tusk,"Comedy,Drama,Horror",Comedy,"['Drama', 'Horror']",9,2014,low,3000000,1821983,65571,1887554,-1112446
Barfi,"Comedy,Romance",Comedy,['Romance'],9,2012,low,4600000,2804874,33947110,36751984,32151984
The Masked Saint,"Action,Biography,Crime",Action,"['Biography', 'Crime']",1,2016,low,3500000,182695,0,182695,-3317305
Crazy Rich Asians,"Comedy,Romance",Comedy,['Romance'],8,2018,mid,30000000,174532921,63566790,238099711,208099711
Road Hard,Comedy,Comedy,[],3,2015,low,1500000,113169,0,113169,-1386831
Now You See Me 2,"Action,Adventure,Comedy",Action,"['Adventure', 'Comedy']",6,2016,high,90000000,65075540,263249467,328325007,238325007
Beyond the Lights,"Drama,Music,Romance",Drama,"['Music', 'Romance']",11,2014,mid,7000000,14618727,0,14618727,7618727
Unsullied,"Action,Horror,Thriller",Action,"['Horror', 'Thriller']",4,2016,low,1500000,510957,0,510957,-989043
Hits,"Comedy,Drama",Comedy,['Drama'],2,2015,low,1000000,15156,0,15156,-984844
Thunder and the House of Magic,"Adventure,Animation,Comedy",Adventure,"['Animation', 'Comedy']",9,2014,mid,34000000,4091,62578429,62582520,28582520
Trainwreck,"Comedy,Drama,Romance",Comedy,"['Drama', 'Romance']",7,2015,mid,35000000,110212700,30911197,141123897,106123897
Dawn of the Crescent Moon,"Drama,Sci-Fi,Thriller",Drama,"['Sci-Fi', 'Thriller']",7,2015,low,75000,8799,0,8799,-66201
Rock the Kasbah,"Comedy,Music,War",Comedy,"['Music', 'War']",10,2015,mid,15000000,3020665,365488,3386153,-11613847
Room,"Drama,Thriller",Drama,['Thriller'],10,2015,mid,13000000,14677674,21585109,36262783,23262783
The Diary of a Teenage Girl,"Comedy,Drama,Romance",Comedy,"['Drama', 'Romance']",8,2015,low,2000000,1477002,802957,2279959,279959
The Boy Next Door,"Horror,Thriller",Horror,['Thriller'],1,2015,low,4000000,36006065,17395873,53401938,49401938
Bitter Harvest,"Drama,Romance,War",Drama,"['Romance', 'War']",2,2017,mid,21000000,557241,48921,606162,-20393838
Fantastic Beasts and Where to Find Them,"Adventure,Family,Fantasy",Adventure,"['Family', 'Fantasy']",11,2016,high,180000000,234037575,568365278,802402853,622402853
Brooklyn,"Drama,Music,Musical",Drama,"['Music', 'Musical']",11,2015,mid,11000000,38322743,23753398,62076141,51076141
Fences,"Drama,Family",Drama,['Family'],12,2016,mid,24000000,57682904,6599977,64282881,40282881
Son of God,"Biography,Drama,History",Biography,"['Drama', 'History']",2,2014,mid,22000000,59700064,11249729,70949793,48949793
I Am Wrath,"Action,Crime,Drama",Action,"['Crime', 'Drama']",4,2016,mid,18000000,0,309608,309608,-17690392
Incarnate,"Horror,Thriller",Horror,['Thriller'],12,2016,mid,5000000,4799774,4571262,9371036,4371036
Risen,"Action,Adventure,Drama",Action,"['Adventure', 'Drama']",2,2016,mid,20000000,36880033,9375730,46255763,26255763
It Follows,"Horror,Mystery",Horror,['Mystery'],3,2015,low,2000000,14674077,8576678,23250755,21250755
The Bounce Back,"Comedy,Romance",Comedy,['Romance'],12,2016,low,3000000,321910,99494,421404,-2578596
Sully,"Biography,Drama",Biography,['Drama'],9,2016,high,60000000,125070033,113454523,238524556,178524556
The Three Musketeers,Adventure,Adventure,[],10,2011,high,90000000,20377913,119500000,139877913,49877913
Creative Control,"Drama,Sci-Fi",Drama,['Sci-Fi'],3,2016,low,1000000,63014,0,63014,-936986
Welcome to Marwen,"Biography,Comedy,Drama",Biography,"['Comedy', 'Drama']",12,2018,mid,45000000,10763520,2111402,12874922,-32125078
The Revenant,Horror,Horror,[],12,2015,high,135000000,183637894,349300408,532938302,397938302
London Has Fallen,"Action,Thriller",Action,['Thriller'],3,2016,high,60000000,62524260,132669825,195194085,135194085
War Horse,Drama,Drama,[],12,2011,high,70000000,79883359,76932170,156815529,86815529
Logan,"Action,Drama,Sci-Fi",Action,"['Drama', 'Sci-Fi']",3,2017,high,127000000,226277068,389184326,615461394,488461394
American Ultra,"Action,Comedy,Sci-Fi",Action,"['Comedy', 'Sci-Fi']",8,2015,mid,28000000,14439985,15855043,30295028,2295028
Still Alice,Drama,Drama,[],1,2015,mid,5000000,18656400,23043212,41699612,36699612
Regression,"Crime,Horror,Mystery",Crime,"['Horror', 'Mystery']",10,2015,mid,20000000,55039,15769335,15824374,-4175626
Annabelle,"Horror,Mystery,Thriller",Horror,"['Mystery', 'Thriller']",10,2014,mid,6500000,84273813,172589107,256862920,250362920
Pan,"Adventure,Comedy,Family",Adventure,"['Comedy', 'Family']",10,2015,high,150000000,35088320,116437653,151525973,1525973
Jigsaw,"Crime,Horror,Mystery",Crime,"['Horror', 'Mystery']",10,2017,mid,10000000,38052832,64392364,102445196,92445196
Compadres,"Action,Comedy,Crime",Action,"['Comedy', 'Crime']",4,2016,low,3000000,3127773,4317271,7445044,4445044
Max,"Adventure,Drama,Family",Adventure,"['Drama', 'Family']",6,2015,mid,20000000,42656255,1001902,43658157,23658157
Transformers: The Last Knight,"Action,Adventure,Sci-Fi",Action,"['Adventure', 'Sci-Fi']",6,2017,high,217000000,130168683,472724657,602893340,385893340
The Brothers Grimsby,"Action,Adventure,Comedy",Action,"['Adventure', 'Comedy']",3,2016,mid,35000000,6864016,21856454,28720470,-6279530
X-Men: Apocalypse,"Action,Adventure,Sci-Fi",Action,"['Adventure', 'Sci-Fi']",5,2016,high,178000000,155442489,387095057,542537546,364537546
Jack Reacher: Never Go Back,"Action,Thriller",Action,['Thriller'],10,2016,high,60000000,58697076,101249413,159946489,99946489
Sicario,"Action,Crime,Drama",Action,"['Crime', 'Drama']",9,2015,mid,30000000,46889293,37504456,84393749,54393749
Fist Fight,Comedy,Comedy,[],2,2017,mid,25000000,32187017,8099399,40286416,15286416
Murder on the Orient Express,"Crime,Drama,Mystery",Crime,"['Drama', 'Mystery']",11,2017,high,55000000,102826543,243096187,345922730,290922730
Ferdinand,"Adventure,Animation,Comedy",Adventure,"['Animation', 'Comedy']",12,2017,high,111000000,84410380,205437550,289847930,178847930
A Monster Calls,"Animation,Drama,Fantasy",Animation,"['Drama', 'Fantasy']",1,2017,mid,43000000,3740823,42673707,46414530,3414530
Ice Age: Collision Course,"Adventure,Animation,Comedy",Adventure,"['Animation', 'Comedy']",7,2016,high,105000000,64063008,338093674,402156682,297156682
The Last Station,Documentary,Documentary,[],1,2010,mid,18000000,6617867,9078279,15696146,-2303854
Paul Blart: Mall Cop 2,"Action,Comedy,Crime",Action,"['Comedy', 'Crime']",4,2015,mid,38000000,71091594,36559052,107650646,69650646
War for the Planet of the Apes,"Action,Adventure,Drama",Action,"['Adventure', 'Drama']",7,2017,high,152000000,146880162,342712105,489592267,337592267
10 Days in a Madhouse,Drama,Drama,[],11,2015,mid,12000000,14616,0,14616,-11985384
The Hateful Eight,"Crime,Drama,Mystery",Crime,"['Drama', 'Mystery']",12,2015,high,62000000,54117416,93747470,147864886,85864886
The Lobster,"Comedy,Drama,Romance",Comedy,"['Drama', 'Romance']",3,2016,low,4500000,9196278,8823556,18019834,13519834
Despicable Me 3,"Adventure,Animation,Comedy",Adventure,"['Animation', 'Comedy']",6,2017,high,75000000,264624300,770103450,1034727750,959727750
Z Storm,"Action,Crime",Action,['Crime'],8,2015,mid,7000000,0,2053330,2053330,-4946670
Sing,"Animation,Comedy,Family",Animation,"['Comedy', 'Family']",12,2016,high,75000000,270329045,364125744,634454789,559454789
The Nut Job 2: Nutty by Nature,"Adventure,Animation,Comedy",Adventure,"['Animation', 'Comedy']",8,2017,mid,40000000,28370522,29067867,57438389,17438389
The Walk,"Adventure,Biography,Drama",Adventure,"['Biography', 'Drama']",9,2015,mid,35000000,10161183,51330921,61492104,26492104
Captain America: Civil War,"Action,Adventure,Sci-Fi",Action,"['Adventure', 'Sci-Fi']",5,2016,high,250000000,408084349,731985064,1140069413,890069413
Race,"Biography,Drama,Sport",Biography,"['Drama', 'Sport']",2,2016,mid,5000000,19115191,4630581,23745772,18745772
Thor: Ragnarok,"Action,Adventure,Comedy",Action,"['Adventure', 'Comedy']",11,2017,high,180000000,315058289,531921735,846980024,666980024
Housebound,"Comedy,Horror,Mystery",Comedy,"['Horror', 'Mystery']",10,2014,low,1500000,0,236863,236863,-1263137
The Word,"Drama,Thriller",Drama,['Thriller'],3,2014,low,200000,3648,0,3648,-196352
The Disaster Artist,"Biography,Comedy,Drama",Biography,"['Comedy', 'Drama']",12,2017,mid,10000000,21120616,7597051,28717667,18717667
Moana,"Adventure,Animation,Comedy",Adventure,"['Animation', 'Comedy']",11,2016,high,150000000,248757044,388760321,637517365,487517365
Mechanic: Resurrection,"Action,Adventure,Thriller",Action,"['Adventure', 'Thriller']",8,2016,mid,40000000,21218403,88520437,109738840,69738840
American Made,"Action,Biography,Comedy",Action,"['Biography', 'Comedy']",9,2017,high,50000000,51342000,84227212,135569212,85569212
Whiskey Tango Foxtrot,"Biography,Comedy,Drama",Biography,"['Comedy', 'Drama']",3,2016,mid,35000000,23083334,2267413,25350747,-9649253
Girls Trip,"Comedy,Drama",Comedy,['Drama'],7,2017,mid,28000000,115108515,25777838,140886353,112886353
Vaalu,"Comedy,Romance",Comedy,['Romance'],12,2015,low,1900000,0,12444,12444,-1887556
The Visit,"Horror,Mystery,Thriller",Horror,"['Mystery', 'Thriller']",9,2015,mid,5000000,65206105,33471711,98677816,93677816
Legend,"Biography,Crime,Drama",Biography,"['Crime', 'Drama']",11,2015,mid,25000000,1872994,40552456,42425450,17425450
Not Cool,"Comedy,Drama,Romance",Comedy,"['Drama', 'Romance']",9,2014,low,800000,35688,0,35688,-764312
Bilal: A New Breed of Hero,"Action,Adventure,Animation",Action,"['Adventure', 'Animation']",2,2018,mid,30000000,490973,157626,648599,-29351401
Cars 3,"Adventure,Animation,Comedy",Adventure,"['Animation', 'Comedy']",6,2017,high,175000000,152901115,230640254,383541369,208541369
Incredibles 2,"Action,Adventure,Animation",Action,"['Adventure', 'Animation']",6,2018,high,200000000,608581744,633938967,1242520711,1042520711
A Street Cat Named Bob,"Biography,Comedy,Drama",Biography,"['Comedy', 'Drama']",11,2016,mid,8000000,82703,17299990,17382693,9382693
Jem and the Holograms,"Adventure,Drama,Family",Adventure,"['Drama', 'Family']",10,2015,mid,5000000,2184640,184297,2368937,-2631063
Paper Towns,"Comedy,Drama,Mystery",Comedy,"['Drama', 'Mystery']",7,2015,mid,12000000,32000304,53450180,85450484,73450484
Ricki and the Flash,"Comedy,Drama,Music",Comedy,"['Drama', 'Music']",8,2015,mid,18000000,26839498,14326535,41166033,23166033
Barbershop: The Next Cut,"Comedy,Drama",Comedy,['Drama'],4,2016,mid,20000000,54030051,374151,54404202,34404202
Allied,"Action,Drama,Romance",Action,"['Drama', 'Romance']",11,2016,high,106000000,40098064,79168597,119266661,13266661
Misconduct,"Crime,Drama,Mystery",Crime,"['Drama', 'Mystery']",2,2016,mid,11000000,0,2352511,2352511,-8647489
The Martian,"Adventure,Drama,Sci-Fi",Adventure,"['Drama', 'Sci-Fi']",10,2015,high,108000000,228433663,426837780,655271443,547271443
Bodom,"Horror,Mystery,Thriller",Horror,"['Mystery', 'Thriller']",12,2016,low,1250000,0,726460,726460,-523540
Bridge of Spies,"Drama,History,Thriller",Drama,"['History', 'Thriller']",10,2015,mid,40000000,72313754,90184584,162498338,122498338
Criminal Activities,"Crime,Drama,Thriller",Crime,"['Drama', 'Thriller']",11,2015,mid,7000000,0,386744,386744,-6613256
The BFG,"Adventure,Family,Fantasy",Adventure,"['Family', 'Fantasy']",7,2016,high,140000000,55483770,144162910,199646680,59646680
Creature,"Biography,Crime,Documentary",Biography,"['Crime', 'Documentary']",9,2011,low,3000000,331000,0,331000,-2669000
The Other Side of the Door,Horror,Horror,[],3,2016,mid,5000000,3000342,9904765,12905107,7905107
Unfriended,"Horror,Mystery,Thriller",Horror,"['Mystery', 'Thriller']",4,2015,low,1000000,32789645,31574553,64364198,63364198
Underworld: Blood Wars,"Action,Adventure,Fantasy",Action,"['Adventure', 'Fantasy']",1,2017,mid,35000000,30353973,50855249,81209222,46209222
Power Rangers,"Action,Adventure,Sci-Fi",Action,"['Adventure', 'Sci-Fi']",3,2017,high,120000000,85364450,57167102,142531552,22531552
My All-American,"Biography,Drama,Sport",Biography,"['Drama', 'Sport']",11,2015,mid,20000000,2246000,0,2246000,-17754000
American Honey,"Adventure,Drama,Romance",Adventure,"['Drama', 'Romance']",9,2016,low,3500000,663247,1948503,2611750,-888250
The Lady in the Van,"Biography,Comedy,Drama",Biography,"['Comedy', 'Drama']",1,2016,mid,6000000,10021175,32299328,42320503,36320503
Kong: Skull Island,"Action,Adventure,Fantasy",Action,"['Adventure', 'Fantasy']",3,2017,high,185000000,168052812,393019247,561072059,376072059
Godzilla: King of the Monsters,"Action,Adventure,Fantasy",Action,"['Adventure', 'Fantasy']",5,2019,high,170000000,85576941,213700000,299276941,129276941
The Losers,Drama,Drama,[],4,2010,mid,25000000,23591432,6272408,29863840,4863840
Rogue One: A Star Wars Story,"Action,Adventure,Sci-Fi",Action,"['Adventure', 'Sci-Fi']",12,2016,high,200000000,532177324,516925532,1049102856,849102856
My Big Fat Greek Wedding 2,"Comedy,Romance",Comedy,['Romance'],3,2016,mid,18000000,59689605,32406953,92096558,74096558
The Equalizer 2,"Action,Crime,Thriller",Action,"['Crime', 'Thriller']",7,2018,high,77000000,102084362,88368770,190453132,113453132
Snowden,"Biography,Drama,Thriller",Biography,"['Drama', 'Thriller']",9,2016,high,50000000,21587519,13793399,35380918,-14619082
Solo: A Star Wars Story,"Action,Adventure,Fantasy",Action,"['Adventure', 'Fantasy']",5,2018,high,275000000,213767512,179383835,393151347,118151347
Won't Back Down,Sport,Sport,[],9,2012,mid,19000000,5310554,434949,5745503,-13254497
La La Land,"Comedy,Drama,Music",Comedy,"['Drama', 'Music']",12,2016,mid,20000000,151101803,275249360,426351163,406351163
Lincoln,"Biography,Documentary,History",Biography,"['Documentary', 'History']",11,2012,high,65000000,182207973,91138308,273346281,208346281
We Are Your Friends,"Drama,Music,Romance",Drama,"['Music', 'Romance']",8,2015,low,2000000,3591417,6561998,10153415,8153415
The Nice Guys,"Action,Comedy,Crime",Action,"['Comedy', 'Crime']",5,2016,high,50000000,36261763,23334984,59596747,9596747
Cop Car,"Crime,Thriller",Crime,['Thriller'],8,2015,mid,5000000,134552,9106,143658,-4856342
The Predator,"Action,Adventure,Sci-Fi",Action,"['Adventure', 'Sci-Fi']",9,2018,high,88000000,51024708,108462855,159487563,71487563
Only the Brave,"Action,Biography,Drama",Action,"['Biography', 'Drama']",10,2017,mid,38000000,18340051,6215126,24555177,-13444823
War Room,Drama,Drama,[],8,2015,low,3000000,67790117,6185122,73975239,70975239
31,"Horror,Thriller",Horror,['Thriller'],10,2016,low,1500000,779820,142907,922727,-577273
Yoga Hosers,"Action,Comedy,Fantasy",Action,"['Comedy', 'Fantasy']",9,2016,mid,5000000,0,22958,22958,-4977042
The Overnight,"Comedy,Mystery",Comedy,['Mystery'],6,2015,low,200000,1109808,56188,1165996,965996
Dope,"Comedy,Crime,Drama",Comedy,"['Crime', 'Drama']",6,2015,mid,7000000,17506470,684361,18190831,11190831
Krampus,"Comedy,Fantasy,Horror",Comedy,"['Fantasy', 'Horror']",12,2015,mid,15000000,42725475,19062918,61788393,46788393
The Bronze,"Comedy,Drama,Sport",Comedy,"['Drama', 'Sport']",3,2016,low,3500000,615816,0,615816,-2884184
Dumbo,"Adventure,Family,Fantasy",Adventure,"['Family', 'Fantasy']",3,2019,high,170000000,113883318,231121104,345004422,175004422
The Perfect Guy,"Crime,Drama,Horror",Crime,"['Drama', 'Horror']",9,2015,mid,18000000,57027435,3250731,60278166,42278166
Bajrangi Bhaijaan,"Action,Comedy,Drama",Action,"['Comedy', 'Drama']",7,2015,mid,13000000,8178001,113600346,121778347,108778347
The Boss Baby,"Adventure,Animation,Comedy",Adventure,"['Animation', 'Comedy']",3,2017,high,125000000,175003033,335875729,510878762,385878762
The Boy,"Horror,Mystery,Thriller",Horror,"['Mystery', 'Thriller']",1,2016,mid,10000000,35819556,32401396,68220952,58220952
Baby Driver,"Action,Crime,Drama",Action,"['Crime', 'Drama']",6,2017,mid,34000000,107825862,120278323,228104185,194104185
The Space Between Us,"Adventure,Drama,Romance",Adventure,"['Drama', 'Romance']",2,2017,mid,30000000,7885294,8596111,16481405,-13518595
Teenage Mutant Ninja Turtles: Out of the Shadows,"Action,Adventure,Comedy",Action,"['Adventure', 'Comedy']",6,2016,high,135000000,82051601,163276773,245328374,110328374
Popstar: Never Stop Never Stopping,"Comedy,Music",Comedy,['Music'],6,2016,mid,20000000,9496130,40990,9537120,-10462880
Mustang,Drama,Drama,[],11,2015,low,1400000,845464,4707120,5552584,4152584
Hercules,Comedy,Comedy,[],7,2014,high,100000000,72688614,170700000,243388614,143388614
Meet the Mormons,Documentary,Documentary,[],10,2014,low,2000000,6047363,1808,6049171,4049171
The Bye Bye Man,"Drama,Fantasy,Horror",Drama,"['Fantasy', 'Horror']",1,2017,mid,7400000,22395806,8791921,31187727,23787727
Manchester by the Sea,Drama,Drama,[],11,2016,mid,8500000,47695371,30038496,77733867,69233867
Swiss Army Man,"Adventure,Comedy,Drama",Adventure,"['Comedy', 'Drama']",6,2016,low,3000000,4210454,1626657,5837111,2837111
Maze Runner: The Scorch Trials,"Action,Sci-Fi,Thriller",Action,"['Sci-Fi', 'Thriller']",9,2015,high,61000000,81697192,228868970,310566162,249566162
The Shallows,"Drama,Horror,Thriller",Drama,"['Horror', 'Thriller']",6,2016,mid,13000000,55121623,63641819,118763442,105763442
Green Room,"Horror,Music,Thriller",Horror,"['Music', 'Thriller']",4,2016,mid,5000000,3220371,587132,3807503,-1192497
The Darkest Minds,"Action,Adventure,Drama",Action,"['Adventure', 'Drama']",8,2018,mid,34000000,12695691,25665737,38361428,4361428
Life During Wartime,"Documentary,History",Documentary,['History'],7,2010,low,4500000,281447,0,281447,-4218553
Sardaar Ji,"Comedy,Fantasy,Horror",Comedy,"['Fantasy', 'Horror']",12,2015,low,2700000,0,8200000,8200000,5500000
Dheepan,"Crime,Drama",Crime,['Drama'],5,2016,mid,9000000,248795,7455562,7704357,-1295643
The Purge: Election Year,"Action,Horror,Sci-Fi",Action,"['Horror', 'Sci-Fi']",7,2016,mid,10000000,79042440,39472287,118514727,108514727
Forever My Girl,"Drama,Music,Romance",Drama,"['Music', 'Romance']",1,2018,low,3500000,16376066,0,16376066,12876066
The Lego Batman Movie,"Action,Animation,Comedy",Action,"['Animation', 'Comedy']",2,2017,high,80000000,175750384,134909634,310660018,230660018
The Divide,Western,Western,[],1,2012,low,3000000,18000,138362,156362,-2843638
Fantastic Beasts: The Crimes of Grindelwald,"Adventure,Family,Fantasy",Adventure,"['Family', 'Fantasy']",11,2018,high,200000000,159555901,492664185,652220086,452220086
Florence Foster Jenkins,"Biography,Comedy,Drama",Biography,"['Comedy', 'Drama']",8,2016,mid,29000000,27383770,28616569,56000339,27000339
Keanu,"Action,Comedy,Crime",Action,"['Comedy', 'Crime']",4,2016,mid,15000000,20591853,96288,20688141,5688141
Captain Marvel,"Action,Adventure,Sci-Fi",Action,"['Adventure', 'Sci-Fi']",3,2019,high,175000000,426525952,696535598,1123061550,948061550
Avengers: Infinity War,"Action,Adventure,Sci-Fi",Action,"['Adventure', 'Sci-Fi']",4,2018,high,300000000,678815482,1369318718,2048134200,1748134200
Free Fire,"Action,Comedy,Crime",Action,"['Comedy', 'Crime']",4,2017,mid,10000000,1799322,1994417,3793739,-6206261
Warrior,Drama,Drama,[],9,2011,mid,25000000,13657115,10558270,24215385,-784615
Woodlawn,"Drama,Sport",Drama,['Sport'],10,2015,mid,13000000,14394097,9606,14403703,1403703
Meet the Blacks,"Comedy,Horror",Comedy,['Horror'],4,2016,low,900000,9097072,0,9097072,8197072
The Birth of a Nation,"Biography,Drama,History",Biography,"['Drama', 'History']",10,2016,mid,10000000,15861566,1029445,16891011,6891011
Jason Bourne,"Action,Thriller",Action,['Thriller'],7,2016,high,120000000,162192920,253975396,416168316,296168316
Top Spin,Documentary,Documentary,[],8,2015,low,150000,5858,0,5858,-144142
The Fits,"Drama,Music",Drama,['Music'],6,2016,low,170000,166425,2817,169242,-758
The Darkest Hour,"Documentary,News",Documentary,['News'],12,2011,mid,34800000,21443494,41388221,62831715,28031715
Kicks,"Adventure,Drama",Adventure,['Drama'],9,2016,mid,10000000,150191,0,150191,-9849809
Miracles from Heaven,"Biography,Drama,Family",Biography,"['Drama', 'Family']",3,2016,mid,13000000,61705123,12093613,73798736,60798736
Krisha,Drama,Drama,[],3,2016,low,30000,144822,0,144822,114822
The Founder,"Biography,Drama,History",Biography,"['Drama', 'History']",1,2017,mid,15000000,12786053,11617139,24403192,9403192
Wonder Woman,"Documentary,Drama,Sport",Documentary,"['Drama', 'Sport']",6,2017,high,150000000,412563408,408569970,821133378,671133378
By the Sea,Drama,Drama,[],11,2015,mid,20000000,538460,3189286,3727746,-16272254
Kubo and the Two Strings,"Action,Adventure,Animation",Action,"['Adventure', 'Animation']",8,2016,high,55000000,48023088,29525034,77548122,22548122
Triangle,Documentary,Documentary,[],2,2010,mid,12000000,0,1594955,1594955,-10405045
Big Eyes,Documentary,Documentary,[],12,2014,mid,10000000,14482031,12835841,27317872,17317872
They Will Have to Kill Us First,Documentary,Documentary,[],3,2016,low,600000,0,7943,7943,-592057
90 Minutes in Heaven,Drama,Drama,[],9,2015,mid,5000000,4816142,0,4816142,-183858
Queen of Katwe,"Biography,Drama,Sport",Biography,"['Drama', 'Sport']",9,2016,mid,15000000,8874389,1181092,10055481,-4944519
Creed,"Crime,Drama",Crime,['Drama'],11,2015,mid,37000000,109767581,63800000,173567581,136567581
The Joneses,"Biography,Documentary",Biography,['Documentary'],4,2010,mid,10000000,1475746,2065819,3541565,-6458435
Ouija: Origin of Evil,"Drama,Horror,Mystery",Drama,"['Horror', 'Mystery']",10,2016,mid,9000000,35144505,46687361,81831866,72831866
Julija in alfa Romeo,Comedy,Comedy,[],12,2015,low,560000,0,8462,8462,-551538
In Dubious Battle,Drama,Drama,[],2,2017,mid,15000000,0,214182,214182,-14785818
Two Lovers and a Bear,"Adventure,Drama,Romance",Adventure,"['Drama', 'Romance']",1,2017,mid,6840000,0,22273,22273,-6817727
Neighbors 2: Sorority Rising,Comedy,Comedy,[],5,2016,mid,35000000,55340730,53416891,108757621,73757621
Before We Go,"Documentary,Drama,News",Documentary,"['Drama', 'News']",9,2015,low,3000000,37151,446787,483938,-2516062
Counting,Documentary,Documentary,[],7,2015,low,50000,8374,0,8374,-41626
Shaft,"Action,Comedy,Crime",Action,"['Comedy', 'Crime']",6,2019,mid,30000000,600000,0,600000,-29400000
Fifty Shades Darker,"Drama,Romance",Drama,['Romance'],2,2017,high,55000000,114434010,266964482,381398492,326398492
Fifty Shades Freed,"Drama,Romance,Thriller",Drama,"['Romance', 'Thriller']",2,2018,high,55000000,100407760,270942859,371350619,316350619
Gifted,Drama,Drama,[],4,2017,mid,7000000,24801212,12163444,36964656,29964656
The House,"Comedy,Crime",Comedy,['Crime'],6,2017,mid,40000000,25584504,5607921,31192425,-8807575
Why Him?,Comedy,Comedy,[],12,2016,mid,38000000,60323786,57101370,117425156,79425156
The Meddler,"Comedy,Drama,Romance",Comedy,"['Drama', 'Romance']",4,2016,low,3200000,4267219,1259723,5526942,2326942
The Prodigy,"Horror,Thriller",Horror,['Thriller'],2,2019,mid,6000000,14856291,4933421,19789712,13789712
Morgan,"Action,Horror,Sci-Fi",Action,"['Horror', 'Sci-Fi']",9,2016,mid,8000000,3915251,3383535,7298786,-701214
White Boy Rick,"Crime,Drama",Crime,['Drama'],9,2018,mid,30000000,24004833,1943150,25947983,-4052017
Buried,Thriller,Thriller,[],9,2010,low,1987650,1044143,20226147,21270290,19282640
Miss Sloane,"Drama,Thriller",Drama,['Thriller'],11,2016,mid,18000000,3500605,4219025,7719630,-10280370
The Invitation,Documentary,Documentary,[],4,2016,low,1000000,231738,123098,354836,-645164
Nocturnal Animals,"Drama,Thriller",Drama,['Thriller'],11,2016,mid,22500000,10663357,21735324,32398681,9898681
Darkest Hour,"Biography,Drama,History",Biography,"['Drama', 'History']",11,2017,mid,30000000,56443120,94364052,150807172,120807172
Mile 22,"Action,Adventure,Thriller",Action,"['Adventure', 'Thriller']",8,2018,mid,35000000,36108758,30186363,66295121,31295121
Patriots Day,"Action,Crime,Drama",Action,"['Crime', 'Drama']",12,2016,mid,40000000,31886361,20951628,52837989,12837989
Sleight,"Action,Drama,Sci-Fi",Action,"['Drama', 'Sci-Fi']",4,2017,low,250000,3930990,3460,3934450,3684450
Christopher Robin,"Adventure,Animation,Comedy",Adventure,"['Animation', 'Comedy']",8,2018,high,75000000,99215042,98289716,197504758,122504758
La chambre bleue,Documentary,Documentary,[],10,2014,low,1400000,260441,1684979,1945420,545420
The Star,"Adventure,Animation,Comedy",Adventure,"['Animation', 'Comedy']",11,2017,mid,20000000,40847995,21910015,62758010,42758010
Karachi se Lahore,"Adventure,Comedy,Family",Adventure,"['Comedy', 'Family']",12,2015,low,1000000,0,17721,17721,-982279
Can You Ever Forgive Me?,"Biography,Comedy,Crime",Biography,"['Comedy', 'Crime']",10,2018,mid,10000000,8803865,2948522,11752387,1752387
Burnt,"Comedy,Drama",Comedy,['Drama'],10,2015,mid,20000000,13651946,23121564,36773510,16773510
Battle of the Sexes,"Biography,Comedy,Drama",Biography,"['Comedy', 'Drama']",9,2017,mid,25000000,12638526,5806853,18445379,-6554621
Wolves,"Drama,Sport",Drama,['Sport'],11,2014,mid,18000000,0,94953,94953,-17905047
Storks,"Adventure,Animation,Comedy",Adventure,"['Animation', 'Comedy']",9,2016,high,70000000,72679278,110674153,183353431,113353431
The Fate of the Furious,"Action,Crime,Thriller",Action,"['Crime', 'Thriller']",4,2017,high,250000000,225764765,1009081502,1234846267,984846267
Braid,"Horror,Mystery,Thriller",Horror,"['Mystery', 'Thriller']",2,2019,low,1660000,0,80745,80745,-1579255
Almost Christmas,"Comedy,Drama",Comedy,['Drama'],11,2016,mid,17000000,42065185,428321,42493506,25493506
Kingsman: The Golden Circle,"Action,Adventure,Comedy",Action,"['Adventure', 'Comedy']",9,2017,high,104000000,100234838,308568858,408803696,304803696
Bad Moms,Comedy,Comedy,[],7,2016,mid,20000000,113257297,67741419,180998716,160998716
All Saints,Drama,Drama,[],8,2017,low,2000000,5802208,139786,5941994,3941994
Fifty Shades of Black,Comedy,Comedy,[],1,2016,mid,5000000,11686940,10426135,22113075,17113075
Kevin Hart: What Now?,"Comedy,Documentary",Comedy,['Documentary'],10,2016,mid,10000000,23591043,0,23591043,13591043
On the Basis of Sex,"Biography,Drama",Biography,['Drama'],12,2018,mid,20000000,24622687,13450690,38073377,18073377
Stranded,Documentary,Documentary,[],7,2013,low,1900000,0,285593,285593,-1614407
Collateral Beauty,"Drama,Romance",Drama,['Romance'],12,2016,mid,36000000,31016021,54293072,85309093,49309093
Lion,"Action,Drama,Romance",Action,"['Drama', 'Romance']",11,2016,mid,12000000,51739495,97831225,149570720,137570720
It Comes at Night,"Horror,Mystery",Horror,['Mystery'],6,2017,mid,5000000,13985117,5735086,19720203,14720203
The Sitter,Horror,Horror,[],12,2011,mid,25000000,30542576,8206828,38749404,13749404
Hunt for the Wilderpeople,"Adventure,Comedy,Drama",Adventure,"['Comedy', 'Drama']",6,2016,low,2500000,5205471,18640062,23845533,21345533
Bumblebee,"Action,Adventure,Sci-Fi",Action,"['Adventure', 'Sci-Fi']",12,2018,high,102000000,127195589,338000000,465195589,363195589
Early Man,"Adventure,Animation,Comedy",Adventure,"['Animation', 'Comedy']",2,2018,high,50000000,8267544,37018346,45285890,-4714110
Trash,Drama,Drama,[],10,2015,mid,12000000,17484,6535702,6553186,-5446814
American Hero,"Action,Comedy,Drama",Action,"['Comedy', 'Drama']",12,2015,low,1000000,0,26,26,-999974
The Call,Thriller,Thriller,[],3,2013,mid,12800000,51872378,17949098,69821476,57021476
Air Strike,"Action,Adventure,Drama",Action,"['Adventure', 'Drama']",10,2018,high,65000000,0,516279,516279,-64483721
Unfriended: Dark Web,"Crime,Horror,Mystery",Crime,"['Horror', 'Mystery']",7,2018,low,1000000,8866745,7567843,16434588,15434588
Pitch Perfect 3,"Comedy,Music",Comedy,['Music'],12,2017,mid,45000000,104897530,80838882,185736412,140736412
The Master,Documentary,Documentary,[],9,2012,mid,37500000,16247159,34400257,50647416,13147416
LBJ,"Biography,Drama,History",Biography,"['Drama', 'History']",11,2017,mid,20000000,2468683,38498,2507181,-17492819
The Meg,"Action,Horror,Sci-Fi",Action,"['Horror', 'Sci-Fi']",8,2018,high,178000000,145443742,384086973,529530715,351530715
How to Be a Latin Lover,"Comedy,Drama",Comedy,['Drama'],4,2017,mid,10000000,32149404,30406824,62556228,52556228
Rough Night,"Comedy,Crime,Thriller",Comedy,"['Crime', 'Thriller']",6,2017,mid,20000000,22105643,24738714,46844357,26844357
The Best of Enemies,"Biography,Drama,History",Biography,"['Drama', 'History']",4,2019,mid,10000000,10205616,0,10205616,205616
Sultan,"Action,Drama,Sport",Action,"['Drama', 'Sport']",7,2016,mid,11000000,5599781,67390000,72989781,61989781
Hidden Figures,"Biography,Drama,History",Biography,"['Drama', 'History']",12,2016,mid,25000000,169607287,62164429,231771716,206771716
Blood Feast,Horror,Horror,[],2,2018,low,1200000,8708,0,8708,-1191292
Baahubali 2: The Conclusion,"Action,Drama",Action,['Drama'],4,2017,mid,30000000,18985794,244517120,263502914,233502914
Friend Request,Horror,Horror,[],9,2017,mid,9900000,3759078,7551757,11310835,1410835
The Perfect Match,"Comedy,Romance",Comedy,['Romance'],3,2016,mid,5000000,9669521,512529,10182050,5182050
The Emoji Movie,"Adventure,Animation,Comedy",Adventure,"['Animation', 'Comedy']",7,2017,high,50000000,86089513,130472799,216562312,166562312
Jurassic World: Fallen Kingdom,"Action,Adventure,Sci-Fi",Action,"['Adventure', 'Sci-Fi']",6,2018,high,170000000,417719760,888053039,1305772799,1135772799
Emily,Documentary,Documentary,[],1,2017,low,27000,3547,0,3547,-23453
The Resurrection of Gavin Stone,"Comedy,Drama,Family",Comedy,"['Drama', 'Family']",1,2017,low,2000000,2303792,0,2303792,303792
Widows,Comedy,Comedy,[],11,2018,mid,40000000,42402632,31463456,73866088,33866088
Rush,"Documentary,News",Documentary,['News'],9,2013,mid,38000000,26947624,71283215,98230839,60230839
Lady Bird,"Comedy,Drama",Comedy,['Drama'],11,2017,mid,10000000,48958273,29652496,78610769,68610769
The Darkness,Thriller,Thriller,[],5,2016,low,4000000,10753574,144719,10898293,6898293
The Sisters Brothers,"Adventure,Comedy,Crime",Adventure,"['Comedy', 'Crime']",9,2018,mid,38000000,3143056,10000000,13143056,-24856944
Middle School: The Worst Years of My Life,"Comedy,Family",Comedy,['Family'],10,2016,mid,8500000,20007149,3304144,23311293,14811293
The Forest,"Drama,Fantasy,Horror",Drama,"['Fantasy', 'Horror']",1,2016,mid,10000000,26594261,14154969,40749230,30749230
Housefull,Family,Family,[],4,2010,mid,10100000,1183658,17542642,18726300,8626300
Time to Choose,Documentary,Documentary,[],6,2016,low,3500000,29233,0,29233,-3470767
"Everything, Everything","Drama,Romance",Drama,['Romance'],5,2017,mid,10000000,34121140,27481996,61603136,51603136
Dunkirk,"Action,Drama,History",Action,"['Drama', 'History']",7,2017,high,150000000,190068280,309769088,499837368,349837368
"Three Billboards Outside Ebbing, Missouri","Crime,Drama",Crime,['Drama'],11,2017,mid,12000000,54513740,105678175,160191915,148191915
Mary Poppins Returns,"Comedy,Family,Fantasy",Comedy,"['Family', 'Fantasy']",12,2018,high,130000000,171958438,169570080,341528518,211528518
Get Out,"Horror,Mystery,Thriller",Horror,"['Mystery', 'Thriller']",2,2017,mid,5000000,176040665,79327286,255367951,250367951
Sicario: Day of the Soldado,"Action,Crime,Drama",Action,"['Crime', 'Drama']",6,2018,mid,35000000,50065850,25819346,75885196,40885196
Safe Haven,Horror,Horror,[],2,2013,mid,28000000,71399120,22651831,94050951,66050951
The Favourite,"Biography,Drama,History",Biography,"['Drama', 'History']",11,2018,mid,15000000,34366783,59747146,94113929,79113929
Ant-Man and the Wasp,"Action,Adventure,Comedy",Action,"['Adventure', 'Comedy']",7,2018,high,130000000,216648740,406495920,623144660,493144660
The Three Stooges,Documentary,Documentary,[],4,2012,mid,30000000,44338224,9714025,54052249,24052249
The Secret Life of Pets 2,"Adventure,Animation,Comedy",Adventure,"['Animation', 'Comedy']",6,2019,high,80000000,63795655,49555841,113351496,33351496
Peter Rabbit,"Adventure,Animation,Comedy",Adventure,"['Animation', 'Comedy']",2,2018,high,50000000,115234093,231902384,347136477,297136477
The Eagle,Documentary,Documentary,[],2,2011,mid,25000000,19490041,19503507,38993548,13993548
Paul,Drama,Drama,[],3,2011,mid,40000000,37412945,63749161,101162106,61162106
Annabelle: Creation,"Horror,Mystery,Thriller",Horror,"['Mystery', 'Thriller']",8,2017,mid,15000000,102092201,203292664,305384865,290384865
Mommy,Drama,Drama,[],1,2015,low,4900000,3498695,14037309,17536004,12636004
"Love, Simon","Comedy,Drama,Romance",Comedy,"['Drama', 'Romance']",3,2018,mid,10000000,40826341,24694292,65520633,55520633
Weekend,Horror,Horror,[],9,2011,low,190000,484592,1092993,1577585,1387585
The Drop,Documentary,Documentary,[],9,2014,mid,12600000,10724389,8330145,19054534,6454534
Wuthering Heights,"Horror,Romance",Horror,['Romance'],10,2012,mid,8000000,100915,2620619,2721534,-5278466
Hotel Transylvania 3: Summer Vacation,"Adventure,Animation,Comedy",Adventure,"['Animation', 'Comedy']",7,2018,high,65000000,167500092,359579870,527079962,462079962
The Gunman,Western,Western,[],3,2015,mid,40000000,10664749,7929478,18594227,-21405773
Paterson,"Comedy,Drama,Romance",Comedy,"['Drama', 'Romance']",12,2016,mid,5000000,2141423,8586113,10727536,5727536
Snatched,"Drama,Horror,Mystery",Drama,"['Horror', 'Mystery']",5,2017,mid,42000000,45852178,11999999,57852177,15852177
Marshall,"Biography,Crime,Drama",Biography,"['Crime', 'Drama']",10,2017,mid,12000000,10051659,65157,10116816,-1883184
Happy Death Day,"Horror,Mystery,Thriller",Horror,"['Mystery', 'Thriller']",10,2017,mid,5000000,55683845,69326415,125010260,120010260
Sgt. Stubby: An American Hero,"Adventure,Animation,Family",Adventure,"['Animation', 'Family']",4,2018,mid,25000000,3054285,591672,3645957,-21354043
The Little Prince,Documentary,Documentary,[],2,2016,high,77500000,1311213,100717706,102028919,24528919
Wish Upon,"Drama,Fantasy,Horror",Drama,"['Fantasy', 'Horror']",7,2017,mid,12000000,14301505,9175840,23477345,11477345
Nerve,"Documentary,History",Documentary,['History'],7,2016,mid,20000000,38583626,32068658,70652284,50652284
Lights Out,Documentary,Documentary,[],7,2016,mid,5000000,67268835,81537675,148806510,143806510
Lean on Pete,"Adventure,Drama",Adventure,['Drama'],4,2018,mid,8000000,1163056,1291971,2455027,-5544973
The Hurricane Heist,"Action,Adventure,Crime",Action,"['Adventure', 'Crime']",3,2018,mid,40000000,6115824,24847860,30963684,-9036316
Shanghai,Drama,Drama,[],10,2015,high,50000000,46425,15459497,15505922,-34494078
Logan Lucky,"Comedy,Crime,Drama",Comedy,"['Crime', 'Drama']",8,2017,mid,29000000,27778642,16485629,44264271,15264271
The Big Sick,"Comedy,Drama,Romance",Comedy,"['Drama', 'Romance']",6,2017,mid,5000000,42872467,11100393,53972860,48972860
Deadpool 2,"Action,Adventure,Comedy",Action,"['Adventure', 'Comedy']",5,2018,high,110000000,324591735,462088822,786680557,676680557
Loving,"Drama,Romance",Drama,['Romance'],11,2016,mid,9000000,7710234,5187830,12898064,3898064
Cargo,Drama,Drama,[],10,2011,low,4200000,0,313230,313230,-3886770
The Square,Family,Family,[],4,2010,low,1900000,406216,334716,740932,-1159068
The Square,Family,Family,[],10,2013,low,1500000,124244,52018,176262,-1323738
The Nutcracker and the Four Realms,"Adventure,Family,Fantasy",Adventure,"['Family', 'Fantasy']",11,2018,high,132900000,54858851,115435048,170293899,37393899
The Host,Documentary,Documentary,[],3,2013,high,50000000,26623701,37853350,64477051,14477051
"I, Tonya","Biography,Comedy,Drama",Biography,"['Comedy', 'Drama']",12,2017,mid,11000000,30014534,23782875,53797409,42797409
The Hate U Give,"Crime,Drama",Crime,['Drama'],10,2018,mid,23000000,29719483,5348182,35067665,12067665
The Shape of Water,"Adventure,Drama,Fantasy",Adventure,"['Drama', 'Fantasy']",12,2017,mid,19500000,63859435,131931359,195790794,176290794
Unforgettable,"Drama,Romance",Drama,['Romance'],4,2017,mid,12000000,11368012,4853199,16221211,4221211
Blood Ties,Documentary,Documentary,[],3,2014,mid,26000000,42472,2881487,2923959,-23076041
On the Road,Drama,Drama,[],3,2013,mid,25000000,720828,8592474,9313302,-15686698
Thoroughbreds,"Comedy,Crime,Drama",Comedy,"['Crime', 'Drama']",3,2018,mid,5000000,3072605,114697,3187302,-1812698
The Florida Project,Drama,Drama,[],10,2017,low,2000000,5904366,5390958,11295324,9295324
Goosebumps 2: Haunted Halloween,"Adventure,Comedy,Family",Adventure,"['Comedy', 'Family']",10,2018,mid,35000000,46697321,46594157,93291478,58291478
Survivor,"Crime,Thriller",Crime,['Thriller'],5,2015,mid,20000000,0,1703281,1703281,-18296719
Sorry to Bother You,"Comedy,Fantasy,Sci-Fi",Comedy,"['Fantasy', 'Sci-Fi']",7,2018,low,3200000,17493096,792464,18285560,15085560
Home Again,"Comedy,Drama,Romance",Comedy,"['Drama', 'Romance']",9,2017,mid,15000000,27020284,10316590,37336874,22336874
Cold Pursuit,"Action,Crime,Drama",Action,"['Crime', 'Drama']",2,2019,high,60000000,32138862,30460297,62599159,2599159
Just Getting Started,"Action,Comedy",Action,['Comedy'],12,2017,mid,22000000,6069605,686807,6756412,-15243588
Insidious: The Last Key,"Horror,Mystery,Thriller",Horror,"['Mystery', 'Thriller']",1,2018,mid,10000000,67745330,100140258,167885588,157885588
The Possession of Hannah Grace,"Horror,Mystery,Thriller",Horror,"['Mystery', 'Thriller']",11,2018,mid,6000000,14836174,27949213,42785387,36785387
Rio,Drama,Drama,[],4,2011,high,90000000,143619809,343900000,487519809,397519809
Skyscraper,"Action,Adventure,Thriller",Action,"['Adventure', 'Thriller']",7,2018,high,125000000,68420120,235695414,304115534,179115534
The Lovers,"Comedy,Drama,Romance",Comedy,"['Drama', 'Romance']",3,2015,mid,35000000,0,53899,53899,-34946101
I Am Not Your Negro,Documentary,Documentary,[],2,2017,low,1000000,7123919,2493483,9617402,8617402
Oddball,Documentary,Documentary,[],12,2016,mid,7000000,0,10237229,10237229,3237229
Hotel Artemis,"Action,Drama,Sci-Fi",Action,"['Drama', 'Sci-Fi']",6,2018,mid,15000000,6708137,6050662,12758799,-2241201
The Descendants,Drama,Drama,[],11,2011,mid,20000000,82624961,92882839,175507800,155507800
Total Recall,Action,Action,[],8,2012,high,125000000,58877969,152978119,211856088,86856088
Another Year,Documentary,Documentary,[],12,2010,mid,8000000,3205706,16799907,20005613,12005613
Denial,Documentary,Documentary,[],9,2016,mid,10000000,4073448,5190492,9263940,-736060
Slender Man,"Adventure,Comedy,Horror",Adventure,"['Comedy', 'Horror']",8,2018,mid,10000000,30564825,21158819,51723644,41723644
Project X,Mystery,Mystery,[],3,2012,mid,12000000,54731865,48296323,103028188,91028188
Dangal,Action,Action,[],12,2016,mid,9500000,12391761,282262857,294654618,285154618
The Professor and the Madman,"Biography,Drama,Mystery",Biography,"['Drama', 'Mystery']",5,2019,mid,25000000,0,5227233,5227233,-19772767
Moonlight,Horror,Horror,[],10,2016,low,1500000,27854931,37390581,65245512,63745512
Bernie,Family,Family,[],4,2012,mid,6000000,9204489,902486,10106975,4106975
Miss Bala,"Action,Crime,Drama",Action,"['Crime', 'Drama']",2,2019,mid,15000000,14998027,364271,15362298,362298
Captive State,"Sci-Fi,Thriller",Sci-Fi,['Thriller'],3,2019,mid,25000000,5958315,3034985,8993300,-16006700
Left Behind,"Documentary,Drama",Documentary,['Drama'],10,2014,mid,16000000,14019924,6749285,20769209,4769209
"Roman J. Israel, Esq.","Crime,Drama,Thriller",Crime,"['Drama', 'Thriller']",11,2017,mid,22000000,11962712,1004300,12967012,-9032988
Diary of a Wimpy Kid: The Long Haul,"Comedy,Family",Comedy,['Family'],5,2017,mid,22000000,20738724,14870853,35609577,13609577
Destiny,Western,Western,[],12,2014,low,750000,0,450,450,-749550
Kin,"Action,Drama,Sci-Fi",Action,"['Drama', 'Sci-Fi']",8,2018,mid,30000000,5718096,4378725,10096821,-19903179
The Perfect Host,Fantasy,Fantasy,[],7,2011,low,1000000,48764,2823,51587,-948413
First Reformed,"Drama,Mystery,Thriller",Drama,"['Mystery', 'Thriller']",5,2018,low,3500000,3448256,426516,3874772,374772
Acrimony,"Drama,Romance,Thriller",Drama,"['Romance', 'Thriller']",3,2018,mid,20000000,43549096,3078740,46627836,26627836
Life,Comedy,Comedy,[],3,2017,high,58000000,30234022,70695644,100929666,42929666
Limitless,Documentary,Documentary,[],3,2011,mid,27000000,79249455,76315464,155564919,128564919
Burn,Thriller,Thriller,[],7,2012,low,225000,1109276,0,1109276,884276
Barbecue,Documentary,Documentary,[],12,2014,mid,10000000,388,247177,247565,-9752435
Brotherly Love,Drama,Drama,[],4,2015,low,1900000,478595,0,478595,-1421405
Knock Knock,Horror,Horror,[],10,2015,low,2000000,36336,6292180,6328516,4328516
Late Night,"Comedy,Drama",Comedy,['Drama'],6,2019,low,4000000,246305,0,246305,-3753695
The First Purge,"Action,Horror,Sci-Fi",Action,"['Horror', 'Sci-Fi']",7,2018,mid,13000000,69488745,67128560,136617305,123617305
Lucy,Documentary,Documentary,[],7,2014,mid,40000000,126573960,330933816,457507776,417507776
Split,"Action,Drama,Sport",Action,"['Drama', 'Sport']",1,2017,mid,5000000,138141585,140823221,278964806,273964806
The Runaways,Adventure,Adventure,[],3,2010,mid,9500000,3573673,1704959,5278632,-4221368
Posledniy bogatyr,"Action,Adventure,Comedy",Action,"['Adventure', 'Comedy']",12,2017,mid,8500000,0,30700192,30700192,22200192
Smallfoot,"Adventure,Animation,Comedy",Adventure,"['Animation', 'Comedy']",9,2018,high,80000000,83240103,130451174,213691277,133691277
The Judge,Documentary,Documentary,[],10,2014,high,50000000,47119388,29000000,76119388,26119388
The Town,Horror,Horror,[],9,2010,mid,37000000,92186262,60380619,152566881,115566881
A Ghost Story,"Drama,Fantasy,Romance",Drama,"['Fantasy', 'Romance']",7,2017,low,100000,1594798,1174984,2769782,2669782
Vice,"Biography,Comedy,Drama",Biography,"['Comedy', 'Drama']",12,2018,high,60000000,47836282,23046889,70883171,10883171
Black or White,"Action,Drama,Thriller",Action,"['Drama', 'Thriller']",1,2015,mid,9000000,21571189,399832,21971021,12971021
Patti Cake$,"Drama,Music",Drama,['Music'],8,2017,low,1000000,800148,670942,1471090,471090
The Post,"Biography,Drama,History",Biography,"['Drama', 'History']",12,2017,high,50000000,81903458,97845422,179748880,129748880
Adrift,"Action,Adventure,Biography",Action,"['Adventure', 'Biography']",6,2018,mid,35000000,31445011,26452180,57897191,22897191
Alpha,"Crime,Drama,Fantasy",Crime,"['Drama', 'Fantasy']",8,2018,high,51000000,35851379,63773494,99624873,48624873
Life as We Know It,Comedy,Comedy,[],10,2010,mid,38000000,53374681,52513156,105887837,67887837
Creed II,"Drama,Sport",Drama,['Sport'],11,2018,high,50000000,115715889,97875633,213591522,163591522
Stolen,Drama,Drama,[],9,2012,mid,35000000,289773,17677973,17967746,-17032254
The Night Before,Documentary,Documentary,[],11,2015,mid,25000000,43035725,9391621,52427346,27427346
A Bad Moms Christmas,"Adventure,Comedy",Adventure,['Comedy'],11,2017,mid,28000000,72110659,55599891,127710550,99710550
Safe,Thriller,Thriller,[],4,2012,mid,33000000,17142080,24353133,41495213,8495213
Proud Mary,"Action,Crime,Drama",Action,"['Crime', 'Drama']",1,2018,mid,30000000,20868638,840901,21709539,-8290461
Wonder Park,"Adventure,Animation,Comedy",Adventure,"['Animation', 'Comedy']",3,2019,high,100000000,45216793,69932629,115149422,15149422
I Can Only Imagine,"Biography,Drama,Family",Biography,"['Drama', 'Family']",3,2018,mid,7000000,83482352,2121869,85604221,78604221
Five Feet Apart,"Drama,Romance",Drama,['Romance'],3,2019,mid,7000000,45729221,34775200,80504421,73504421
Serenity,"Drama,Mystery,Sci-Fi",Drama,"['Mystery', 'Sci-Fi']",1,2019,mid,25000000,8547045,2819984,11367029,-13632971
Action Point,Comedy,Comedy,[],6,2018,mid,19000000,5059608,44067,5103675,-13896325
Indivisible,"Drama,War",Drama,['War'],10,2018,low,2700000,3511417,76888,3588305,888305
The Apparition,Drama,Drama,[],8,2012,mid,17000000,4936819,5700462,10637281,-6362719
Dark Phoenix,"Action,Adventure,Sci-Fi",Action,"['Adventure', 'Sci-Fi']",6,2019,high,350000000,42762350,107000000,149762350,-200237650
Drive,"Action,Crime,Drama",Action,"['Crime', 'Drama']",9,2011,mid,15000000,35060689,46297241,81357930,66357930
The Immigrant,Drama,Drama,[],5,2014,mid,16000000,2013456,5571555,7585011,-8414989
No Strings Attached,"Comedy,Drama,Romance",Comedy,"['Drama', 'Romance']",1,2011,mid,25000000,70662220,78565858,149228078,124228078
Bad Times at the El Royale,"Crime,Drama,Mystery",Crime,"['Drama', 'Mystery']",10,2018,mid,32000000,17839115,11365264,29204379,-2795621
A Quiet Place,"Drama,Horror,Sci-Fi",Drama,"['Horror', 'Sci-Fi']",4,2018,mid,17000000,188024361,146497933,334522294,317522294
Youth,"Drama,Romance,War",Drama,"['Romance', 'War']",12,2015,mid,13000000,2703296,21298277,24001573,11001573
Carnage,Comedy,Comedy,[],12,2011,mid,25000000,2546747,35565407,38112154,13112154
The Artist,Mystery,Mystery,[],11,2011,mid,16000000,44667095,83589617,128256712,112256712
Safe House,Horror,Horror,[],2,2012,high,85000000,126181630,82360532,208542162,123542162
The Intruder,"Drama,Horror,Mystery",Drama,"['Horror', 'Mystery']",5,2019,mid,8000000,35095904,909967,36005871,28005871
Concussion,Documentary,Documentary,[],12,2015,mid,35000000,34531832,15831958,50363790,15363790
The Awakening,Thriller,Thriller,[],8,2012,low,4900000,95933,6828388,6924321,2024321
Upgrade,Drama,Drama,[],6,2018,low,3000000,11977130,4576155,16553285,13553285
Night School,Comedy,Comedy,[],9,2018,mid,29000000,77339130,25669662,103008792,74008792
I Feel Pretty,"Comedy,Romance",Comedy,['Romance'],4,2018,mid,32000000,48795601,42758196,91553797,59553797
The 15:17 to Paris,"Biography,Drama,Thriller",Biography,"['Drama', 'Thriller']",2,2018,mid,30000000,36276286,19819914,56096200,26096200
The Kid Who Would Be King,"Action,Adventure,Family",Action,"['Adventure', 'Family']",1,2019,high,59000000,16790790,11557656,28348446,-30651554
Glass,"Drama,Sci-Fi,Thriller",Drama,"['Sci-Fi', 'Thriller']",1,2019,mid,20000000,111035005,134268500,245303505,225303505
Peppermint,"Action,Crime,Drama",Action,"['Crime', 'Drama']",9,2018,mid,25000000,35418723,16382035,51800758,26800758
Wanderlust,Documentary,Documentary,[],2,2012,mid,32500000,17288155,6871779,24159934,-8340066
Us,"Horror,Mystery,Thriller",Horror,"['Mystery', 'Thriller']",3,2019,mid,20000000,175006930,79203380,254210310,234210310
Book Club,"Comedy,Drama,Romance",Comedy,"['Drama', 'Romance']",5,2018,mid,10000000,68566296,22547387,91113683,81113683
Kill the Irishman,Crime,Crime,[],3,2011,mid,12000000,1188194,0,1188194,-10811806
Truth or Dare,"Comedy,Drama,Romance",Comedy,"['Drama', 'Romance']",4,2018,low,3500000,41411015,53716329,95127344,91627344
Life of the Party,Drama,Drama,[],5,2018,mid,30000000,53059911,12700000,65759911,35759911
Addicted,Drama,Drama,[],10,2014,mid,5000000,17390770,108472,17499242,12499242
Red Sky,"Drama,War",Drama,['War'],3,2015,mid,25000000,0,91116,91116,-24908884
Do You Believe?,"Fantasy,Horror",Fantasy,['Horror'],3,2015,low,2300000,12985600,1319331,14304931,12004931
Green Book,"Biography,Comedy,Drama",Biography,"['Comedy', 'Drama']",11,2018,mid,23000000,85080171,236954268,322034439,299034439
Test,Drama,Drama,[],6,2014,low,250000,18823,0,18823,-231177
Underdogs,"Documentary,Sport",Documentary,['Sport'],8,2013,low,2500000,35017,1357632,1392649,-1107351
Mandy,"Action,Fantasy,Horror",Action,"['Fantasy', 'Horror']",9,2018,mid,6000000,1214525,213131,1427656,-4572344
Coco,Horror,Horror,[],11,2017,high,175000000,209726015,588282086,798008101,623008101
Eighth Grade,"Comedy,Drama",Comedy,['Drama'],7,2018,low,2000000,13539710,801306,14341016,12341016
Animal Kingdom,"Drama,Fantasy,Horror",Drama,"['Fantasy', 'Horror']",8,2010,low,4200000,1044039,7034644,8078683,3878683
Departure,Drama,Drama,[],3,2017,low,1100000,0,27561,27561,-1072439
First Man,Documentary,Documentary,[],10,2018,high,60000000,44936545,60267280,105203825,45203825
A Simple Favor,"Comedy,Crime,Drama",Comedy,"['Crime', 'Drama']",9,2018,mid,20000000,53548586,44080131,97628717,77628717
The Family,Comedy,Comedy,[],9,2013,mid,30000000,36918811,14159730,51078541,21078541
Let Me In,Horror,Horror,[],10,2010,mid,20000000,12134935,16135464,28270399,8270399
If Beale Street Could Talk,"Drama,Romance",Drama,['Romance'],12,2018,mid,12000000,14915773,4943394,19859167,7859167
Stronger,"Action,Sport",Action,['Sport'],9,2017,mid,30000000,4211129,4575623,8786752,-21213248
Destroyer,"Action,Crime,Drama",Action,"['Crime', 'Drama']",12,2018,mid,9000000,1533324,2147772,3681096,-5318904
Breaking In,"Action,Crime,Drama",Action,"['Crime', 'Drama']",5,2018,mid,6000000,46840590,4571030,51411620,45411620
Unsane,"Drama,Horror,Mystery",Drama,"['Horror', 'Mystery']",3,2018,low,1500000,7690044,6554887,14244931,12744931
Hearts Beat Loud,"Comedy,Drama,Music",Comedy,"['Drama', 'Music']",6,2018,low,2000000,2386254,34708,2420962,420962
Churchill,Biography,Biography,[],6,2017,mid,10000000,1279681,6302515,7582196,-2417804
Freedom,Thriller,Thriller,[],6,2015,mid,14500000,0,872757,872757,-13627243
Arrival,Documentary,Documentary,[],11,2016,mid,47000000,100546139,102581755,203127894,156127894
Uncle Drew,"Comedy,Sport",Comedy,['Sport'],6,2018,mid,18000000,42469946,4057215,46527161,28527161
BlacKkKlansman,"Biography,Crime,Drama",Biography,"['Crime', 'Drama']",8,2018,mid,15000000,49275340,43741995,93017335,78017335
Getaway,Thriller,Thriller,[],8,2013,mid,18000000,10501938,1312051,11813989,-6186011
El Chicano,Drama,Drama,[],5,2019,mid,8000000,700261,0,700261,-7299739
"Paul, Apostle of Christ","Adventure,Biography,Drama",Adventure,"['Biography', 'Drama']",3,2018,mid,5000000,17547999,7981499,25529498,20529498
The Interview,Documentary,Documentary,[],2,2014,mid,44000000,6105175,6237457,12342632,-31657368
Instant Family,"Comedy,Drama",Comedy,['Drama'],11,2018,mid,48000000,67363237,52372951,119736188,71736188
Devil,Drama,Drama,[],9,2010,mid,10000000,33679655,29674459,63354114,53354114
Anna,"Action,Thriller",Action,['Thriller'],6,2014,low,4357373,0,1200000,1200000,-3157373
Super,Adventure,Adventure,[],4,2011,low,2500000,327716,266217,593933,-1906067
Sinister,Drama,Drama,[],10,2012,low,3000000,48086903,39640904,87727807,84727807
Above and Beyond,Documentary,Documentary,[],1,2015,low,1300000,288751,0,288751,-1011249
Hugo,Documentary,Documentary,[],11,2011,high,180000000,73864507,106183277,180047784,47784
Absentia,Sci-Fi,Sci-Fi,[],12,2011,low,70000,0,8555,8555,-61445
The Conspirator,Comedy,Comedy,[],4,2011,mid,25000000,11538204,4369207,15907411,-9092589
The Thing,Documentary,Documentary,[],10,2011,mid,38000000,16999934,10573144,27573078,-10426922
The Great Wall,Documentary,Documentary,[],2,2017,high,150000000,45157105,289329747,334486852,184486852
The Wall,Documentary,Documentary,[],5,2017,low,3000000,1803064,2692198,4495262,1495262
Melancholia,Documentary,Documentary,[],11,2011,mid,9400000,3030848,18786450,21817298,12417298
Phantom,"Crime,Horror,Thriller",Crime,"['Horror', 'Thriller']",3,2013,mid,18000000,1034589,164921,1199510,-16800490
Anonymous,"Action,Comedy,Mystery",Action,"['Comedy', 'Mystery']",10,2011,mid,27500000,4463292,11352217,15815509,-11684491
What Men Want,"Comedy,Fantasy,Romance",Comedy,"['Fantasy', 'Romance']",2,2019,mid,20000000,54611903,15300000,69911903,49911903
Let There Be Light,Drama,Drama,[],10,2017,low,3000000,7233471,7838,7241309,4241309
Annie,"Comedy,Musical",Comedy,['Musical'],12,2014,high,65000000,85911262,53918363,139829625,74829625
Promised Land,Documentary,Documentary,[],1,2013,mid,15000000,7597898,4796664,12394562,-2605438
Tomorrowland,Documentary,Documentary,[],5,2015,high,170000000,93436322,113191196,206627518,36627518
Hereditary,"Drama,Horror,Mystery",Drama,"['Horror', 'Mystery']",6,2018,mid,10000000,44069456,26064449,70133905,60133905
Spotlight,Drama,Drama,[],11,2015,mid,20000000,45055776,47032684,92088460,72088460
Conviction,Drama,Drama,[],10,2010,mid,12500000,6797696,5029284,11826980,-673020
Abduction,"Action,Sci-Fi",Action,['Sci-Fi'],9,2011,mid,35000000,28087155,58561204,86648359,51648359
Tooth Fairy,Horror,Horror,[],1,2010,mid,48000000,60022256,52588130,112610386,64610386
The Mule,"Crime,Drama,Thriller",Crime,"['Drama', 'Thriller']",12,2018,high,50000000,103804407,67053269,170857676,120857676
Dragon Ball Super: Broly,"Action,Adventure,Animation",Action,"['Adventure', 'Animation']",1,2019,mid,8500000,30376755,92371000,122747755,114247755
Heist,"Action,Crime,Drama",Action,"['Crime', 'Drama']",11,2015,mid,8900000,50136,3273995,3324131,-5575869
Remember Me,Thriller,Thriller,[],3,2010,mid,16000000,19068240,37437880,56506120,40506120
Circle,Drama,Drama,[],8,2010,low,2000000,10024,0,10024,-1989976
Teefa in Trouble,"Action,Comedy,Crime",Action,"['Comedy', 'Crime']",7,2018,low,1500000,0,98806,98806,-1401194
Chloe,"Documentary,Family",Documentary,['Family'],3,2010,mid,13000000,3075255,8755876,11831131,-1168869
Happy Death Day 2U,"Drama,Horror,Mystery",Drama,"['Horror', 'Mystery']",2,2019,mid,9000000,28051045,36128450,64179495,55179495
All You Need Is Love,"Comedy,Romance",Comedy,['Romance'],10,2014,low,300000,0,3565259,3565259,3265259
Trance,Documentary,Documentary,[],4,2013,mid,16000000,2322593,20271459,22594052,6594052
Monsters,"Drama,Thriller",Drama,['Thriller'],10,2010,low,500000,237301,5402429,5639730,5139730
One Day,Drama,Drama,[],8,2011,mid,15000000,13843771,45324921,59168692,44168692
Silence,Drama,Drama,[],12,2016,mid,46500000,7100177,16626449,23726626,-22773374
Mama,Drama,Drama,[],1,2013,mid,15000000,71628180,76467386,148095566,133095566
Unfinished Business,Romance,Romance,[],3,2015,mid,35000000,10219501,2994550,13214051,-21785949
Paranoia,Drama,Drama,[],8,2013,mid,40000000,7388654,8952113,16340767,-23659233
Brave,Drama,Drama,[],6,2012,high,185000000,237282182,317324350,554606532,369606532
Trespass,Western,Western,[],10,2011,mid,35000000,16816,769716,786532,-34213468
Joe,Drama,Drama,[],4,2014,low,4000000,373375,0,373375,-3626625
Restless,"Documentary,Drama",Documentary,['Drama'],9,2011,mid,8000000,163753,2608758,2772511,-5227489
Upside Down,Comedy,Comedy,[],3,2013,high,50000000,102118,26284921,26387039,-23612961
Frontera,"Crime,Drama,Family",Crime,"['Drama', 'Family']",9,2014,low,2300000,59696,0,59696,-2240304
Tag,"Action,Comedy",Action,['Comedy'],6,2018,mid,28000000,54730625,22295561,77026186,49026186
Robin Hood,"Action,Adventure,History",Action,"['Adventure', 'History']",5,2010,high,210000000,105487148,216971858,322459006,112459006
Robin Hood,"Action,Adventure,History",Action,"['Adventure', 'History']",11,2018,high,99000000,30824628,53922813,84747441,-14252559
3,Documentary,Documentary,[],9,2011,mid,7200000,59774,235718,295492,-6904508
Fahrenheit 11/9,Documentary,Documentary,[],9,2018,mid,5000000,6352306,301409,6653715,1653715
Redemption,Drama,Drama,[],6,2013,mid,23000000,36686,13556787,13593473,-9406527
Get Hard,Comedy,Comedy,[],3,2015,mid,40000000,90411453,16100000,106511453,66511453
The Circle,Drama,Drama,[],4,2017,mid,18000000,20497844,20154020,40651864,22651864
Like Crazy,Drama,Drama,[],10,2011,low,250000,3395391,333009,3728400,3478400
Stitches,Drama,Drama,[],4,2013,low,2000000,0,63555,63555,-1936445
The Last Stand,Drama,Drama,[],1,2013,mid,30000000,12050299,36280458,48330757,18330757
Trust,"Crime,Drama",Crime,['Drama'],4,2011,low,4000000,120016,0,120016,-3879984
Lawless,"Action,Adventure,Documentary",Action,"['Adventure', 'Documentary']",8,2012,mid,26000000,37397291,16996396,54393687,28393687
The Witch,Horror,Horror,[],2,2016,low,3500000,25138705,15315815,40454520,36954520
Demonic,Documentary,Documentary,[],10,2017,low,3000000,0,4668109,4668109,1668109
Wild,Documentary,Documentary,[],12,2014,mid,15000000,37880356,14580187,52460543,37460543
Red,Drama,Drama,[],10,2010,high,60000000,90380162,106059531,196439693,136439693
Forget Me Not,Documentary,Documentary,[],5,2011,low,1300000,0,13465,13465,-1286535
Cinderella,Drama,Drama,[],3,2015,high,95000000,201151353,333400000,534551353,439551353
Joy,Drama,Drama,[],12,2015,high,60000000,56451232,44682827,101134059,41134059
Genius,Drama,Drama,[],6,2016,mid,17000000,1361045,5904238,7265283,-9734717
The Tree of Life,Documentary,Documentary,[],5,2011,mid,35000000,13305665,48416161,61721826,26721826
Maggie,Drama,Drama,[],5,2015,low,4500000,187112,840648,1027760,-3472240
Unplanned,"Biography,Drama",Biography,['Drama'],3,2019,mid,6000000,18107621,0,18107621,12107621
Brothers,Action,Action,[],8,2015,mid,13000000,656688,17200000,17856688,4856688
"As Above, So Below","Animation,Documentary,Sci-Fi",Animation,"['Documentary', 'Sci-Fi']",8,2014,mid,5000000,21222315,20601751,41824066,36824066
Inferno,Horror,Horror,[],10,2016,high,75000000,34343574,185175793,219519367,144519367
The Tempest,Drama,Drama,[],12,2010,mid,20000000,277943,0,277943,-19722057
Coriolanus,Drama,Drama,[],1,2012,mid,10000000,749641,1429982,2179623,-7820377
Beauty and the Beast,"Family,Fantasy,Musical",Family,"['Fantasy', 'Musical']",3,2017,high,160000000,504014165,755185541,1259199706,1099199706
The Gambler,"Action,Sci-Fi,Thriller",Action,"['Sci-Fi', 'Thriller']",12,2014,mid,25000000,33680992,5037039,38718031,13718031
The Gift,Romance,Romance,[],8,2015,mid,5000000,43787265,15191212,58978477,53978477
Red Dog,Documentary,Documentary,[],12,2011,mid,9100000,0,20927794,20927794,11827794
Kidnap,"Horror,Thriller",Horror,['Thriller'],8,2017,mid,21000000,30718107,4117973,34836080,13836080
The Book of Life,Family,Family,[],10,2014,high,50000000,50151543,47500000,97651543,47651543
Aladdin,Fantasy,Fantasy,[],5,2019,high,182000000,246734314,372500000,619234314,437234314
Home,"Action,History,War",Action,"['History', 'War']",3,2015,high,130000000,177397510,208600386,385997896,255997896
Neighbors,Drama,Drama,[],5,2014,mid,18000000,150086800,120857628,270944428,252944428
Into the Woods,"Fantasy,Horror",Fantasy,['Horror'],12,2014,high,56200000,128002372,85114029,213116401,156916401
Never Let Me Go,Drama,Drama,[],9,2010,mid,15000000,2434652,8739066,11173718,-3826282
The Girl on the Train,"Horror,Mystery,Thriller",Horror,"['Mystery', 'Thriller']",10,2016,mid,45000000,75395035,98883179,174278214,129278214
Captive,Drama,Drama,[],9,2015,low,2000000,2583301,208672,2791973,791973
The First Time,Drama,Drama,[],10,2012,low,2000000,17061,0,17061,-1982939
Sisters,"Action,Drama",Action,['Drama'],12,2015,mid,30000000,87044645,18986015,106030660,76030660
The Promise,Drama,Drama,[],4,2017,high,90000000,8224288,2327129,10551417,-79448583
Columbus,Comedy,Comedy,[],8,2017,low,700000,1017107,93404,1110511,410511
Unstoppable,Documentary,Documentary,[],11,2010,high,95000000,81562942,84157979,165720921,70720921
