movie,genres,main_genre,subgenres,release_month,release_year,budget,production_budget,domestic_gross,foreign_gross,worldwide_gross,total_profit,ROI
Foodfight!,"Action,Animation,Comedy",Action,"['Animation', 'Comedy']",12,2012,mid,45000000,0,73706,73706,-44926294,0.1637911111111111
The Secret Life of Walter Mitty,"Adventure,Comedy,Drama",Adventure,"['Comedy', 'Drama']",12,2013,high,91000000,58236838,129624345,187861183,96861183,206.44086043956045
A Walk Among the Tombstones,"Action,Crime,Drama",Action,"['Crime', 'Drama']",9,2014,mid,28000000,26017685,36090902,62108587,34108587,221.81638214285715
Jurassic World,"Action,Adventure,Sci-Fi",Action,"['Adventure', 'Sci-Fi']",6,2015,high,215000000,652270625,996584239,1648854864,1433854864,766.9092390697674
The Rum Diary,"Comedy,Drama",Comedy,['Drama'],10,2011,mid,45000000,13109815,8434917,21544732,-23455268,47.87718222222222
Tangled,"Adventure,Animation,Comedy",Adventure,"['Animation', 'Comedy']",11,2010,high,260000000,200821936,385655304,586477240,326477240,225.5681692307692
John Carter,"Action,Adventure,Sci-Fi",Action,"['Adventure', 'Sci-Fi']",3,2012,high,275000000,73058679,209719421,282778100,7778100,102.8284
Dinner for Schmucks,Comedy,Comedy,[],7,2010,high,69000000,73026337,13770165,86796502,17796502,125.79203188405796
The A-Team,"Action,Adventure,Thriller",Action,"['Adventure', 'Thriller']",6,2010,high,110000000,77222099,100019072,177241171,67241171,161.12833727272726
The Possession,"Horror,Mystery,Thriller",Horror,"['Mystery', 'Thriller']",8,2012,mid,14000000,49130588,33794476,82925064,68925064,592.3218857142857
Real Steel,"Action,Drama,Family",Action,"['Drama', 'Family']",10,2011,high,110000000,85463309,178417032,263880341,153880341,239.8912190909091
The Giver,"Drama,Romance,Sci-Fi",Drama,"['Romance', 'Sci-Fi']",8,2014,mid,25000000,45090374,21449831,66540205,41540205,266.16082
Toy Story 3,"Adventure,Animation,Comedy",Adventure,"['Animation', 'Comedy']",6,2010,high,200000000,415004880,653874642,1068879522,868879522,534.439761
Alita: Battle Angel,"Action,Adventure,Sci-Fi",Action,"['Adventure', 'Sci-Fi']",2,2019,high,170000000,85710210,317265826,402976036,232976036,237.04472705882353
The History of Love,"Drama,Romance,War",Drama,"['Romance', 'War']",11,2016,mid,20000000,0,476624,476624,-19523376,2.38312
Shazam!,"Action,Adventure,Comedy",Action,"['Adventure', 'Comedy']",4,2019,high,85000000,139606856,223292877,362899733,277899733,426.94086235294117
Puss in Boots,"Action,Adventure,Animation",Action,"['Adventure', 'Animation']",10,2011,high,130000000,149260504,405726973,554987477,424987477,426.9134438461538
42,"Biography,Drama,Sport",Biography,"['Drama', 'Sport']",4,2013,mid,31000000,95020213,2450488,97470701,66470701,314.42161612903226
Life of Pi,"Adventure,Drama,Fantasy",Adventure,"['Drama', 'Fantasy']",11,2012,high,120000000,124987022,495924981,620912003,500912003,517.4266691666667
The Crazies,"Horror,Thriller",Horror,['Thriller'],2,2010,mid,19000000,39123589,17321945,56445534,37445534,297.0817578947368
The Equalizer,"Action,Crime,Thriller",Action,"['Crime', 'Thriller']",9,2014,high,55000000,101530738,91372886,192903624,137903624,350.7338618181818
Captain America: The First Avenger,"Action,Adventure,Sci-Fi",Action,"['Adventure', 'Sci-Fi']",7,2011,high,140000000,176654505,193915271,370569776,230569776,264.6926971428571
Sin City: A Dame to Kill For,"Crime,Thriller",Crime,['Thriller'],8,2014,high,65000000,13757804,26893038,40650842,-24349158,62.53975692307693
Piranha 3D,"Comedy,Horror",Comedy,['Horror'],8,2010,mid,24000000,25003155,58657005,83660160,59660160,348.584
Margaret,Drama,Drama,[],9,2011,mid,14000000,47185,576107,623292,-13376708,4.4520857142857135
Ex Machina,"Drama,Mystery,Sci-Fi",Drama,"['Mystery', 'Sci-Fi']",4,2015,mid,13000000,25440971,12917421,38358392,25358392,295.06455384615384
Tower Heist,"Action,Comedy,Crime",Action,"['Comedy', 'Crime']",11,2011,high,85000000,78046570,72376376,150422946,65422946,176.9681717647059
The Smurfs,"Adventure,Animation,Comedy",Adventure,"['Animation', 'Comedy']",7,2011,high,110000000,142614158,421135165,563749323,453749323,512.4993845454545
The Mechanic,"Action,Crime,Thriller",Action,"['Crime', 'Thriller']",1,2011,mid,42500000,29121498,47225895,76347393,33847393,179.64092470588236
"Hail, Caesar!","Comedy,Drama,Music",Comedy,"['Drama', 'Music']",2,2016,mid,22000000,30080225,34080455,64160680,42160680,291.63945454545456
Ant-Man,"Action,Adventure,Comedy",Action,"['Adventure', 'Comedy']",7,2015,high,130000000,180202163,338656286,518858449,388858449,399.1218838461538
Season of the Witch,"Action,Adventure,Fantasy",Action,"['Adventure', 'Fantasy']",1,2011,mid,40000000,24827228,66299372,91126600,51126600,227.8165
Hall Pass,"Comedy,Romance",Comedy,['Romance'],2,2011,high,68000000,45060734,42112741,87173475,19173475,128.1962867647059
The Croods,"Action,Adventure,Animation",Action,"['Adventure', 'Animation']",3,2013,high,135000000,187168425,385900000,573068425,438068425,424.4951296296296
Red Tails,"Action,Adventure,Drama",Action,"['Adventure', 'Drama']",1,2012,high,58000000,49876377,489121,50365498,-7634502,86.83706551724137
Something Borrowed,"Comedy,Drama,Romance",Comedy,"['Drama', 'Romance']",5,2011,mid,35000000,39046489,26037627,65084116,30084116,185.95461714285716
Tulip Fever,"Drama,History,Romance",Drama,"['History', 'Romance']",9,2017,mid,25000000,2455635,4337133,6792768,-18207232,27.171072000000002
Furry Vengeance,"Comedy,Family",Comedy,['Family'],4,2010,mid,35000000,17630465,21709712,39340177,4340177,112.4005057142857
Ramona and Beezus,"Adventure,Comedy,Family",Adventure,"['Comedy', 'Family']",7,2010,mid,15000000,26167002,1302619,27469621,12469621,183.13080666666664
Rings,"Drama,Horror,Mystery",Drama,"['Horror', 'Mystery']",2,2017,mid,25000000,27793018,55124265,82917283,57917283,331.669132
A Thousand Words,"Comedy,Drama",Comedy,['Drama'],3,2012,mid,40000000,18450127,2340359,20790486,-19209514,51.976215
What's Your Number?,"Comedy,Romance",Comedy,['Romance'],9,2011,mid,20000000,14011084,16152701,30163785,10163785,150.818925
Samsara,"Documentary,Music",Documentary,['Music'],8,2012,low,4000000,2672413,3294258,5966671,1966671,149.166775
Man of Steel,"Action,Adventure,Sci-Fi",Action,"['Adventure', 'Sci-Fi']",6,2013,high,225000000,291045518,376954000,667999518,442999518,296.88867466666665
The Wolfman,"Drama,Fantasy,Horror",Drama,"['Fantasy', 'Horror']",2,2010,high,150000000,62189884,80444474,142634358,-7365642,95.089572
The Boxtrolls,"Adventure,Animation,Comedy",Adventure,"['Animation', 'Comedy']",9,2014,high,60000000,50837305,61108946,111946251,51946251,186.577085
The Man Who Knew Infinity,"Biography,Drama",Biography,['Drama'],4,2016,mid,10000000,3877922,8504200,12382122,2382122,123.82122
The Incredible Burt Wonderstone,"Adventure,Comedy,Fantasy",Adventure,"['Comedy', 'Fantasy']",3,2013,mid,32000000,22537881,4854728,27392609,-4607391,85.601903125
Dallas Buyers Club,"Biography,Drama",Biography,['Drama'],11,2013,mid,5000000,27298285,33313560,60611845,55611845,1212.2369
Jack Reacher,"Action,Crime,Thriller",Action,"['Crime', 'Thriller']",12,2012,high,60000000,80070736,137300000,217370736,157370736,362.28456
R.I.P.D.,"Action,Adventure,Comedy",Action,"['Adventure', 'Comedy']",7,2013,high,130000000,33618855,45457823,79076678,-50923322,60.828213846153844
Clash of the Titans,"Action,Adventure,Fantasy",Action,"['Adventure', 'Fantasy']",4,2010,high,125000000,163214888,330000000,493214888,368214888,394.57191040000004
Thor,"Action,Adventure,Fantasy",Action,"['Adventure', 'Fantasy']",5,2011,high,150000000,181030624,268295994,449326618,299326618,299.5510786666667
Warcraft,"Action,Adventure,Fantasy",Action,"['Adventure', 'Fantasy']",6,2016,high,160000000,47225655,378296626,425522281,265522281,265.951425625
It's Kind of a Funny Story,"Comedy,Drama,Romance",Comedy,"['Drama', 'Romance']",10,2010,mid,8000000,6363628,269322,6632950,-1367050,82.911875
Jack and Jill,Comedy,Comedy,[],11,2011,high,79000000,74158157,76361060,150519217,71519217,190.53065443037974
Take Me Home Tonight,"Comedy,Drama,Romance",Comedy,"['Drama', 'Romance']",3,2011,mid,19000000,6928068,648536,7576604,-11423396,39.87686315789474
Percy Jackson & the Olympians: The Lightning Thief,"Adventure,Family,Fantasy",Adventure,"['Family', 'Fantasy']",2,2010,high,95000000,88768303,134282571,223050874,128050874,234.79039368421053
She's Out of My League,"Comedy,Romance",Comedy,['Romance'],3,2010,mid,20000000,32010860,16670117,48680977,28680977,243.40488499999998
The Book Thief,"Drama,War",Drama,['War'],11,2013,mid,19000000,21488481,54598230,76086711,57086711,400.4563736842106
Conan the Barbarian,"Action,Adventure,Fantasy",Action,"['Adventure', 'Fantasy']",8,2011,high,90000000,21295021,42061112,63356133,-26643867,70.39570333333333
Interstellar,"Adventure,Drama,Sci-Fi",Adventure,"['Drama', 'Sci-Fi']",11,2014,high,165000000,188017894,478361481,666379375,501379375,403.86628787878783
World War Z,"Action,Adventure,Horror",Action,"['Adventure', 'Horror']",6,2013,high,190000000,202359711,329154939,531514650,341514650,279.7445526315789
Valentine's Day,"Comedy,Romance",Comedy,['Romance'],2,2010,high,52000000,110485654,107083674,217569328,165569328,418.40255384615386
Priest,"Action,Adventure,Fantasy",Action,"['Adventure', 'Fantasy']",5,2011,high,60000000,29136626,55017400,84154026,24154026,140.25671
Dracula Untold,"Action,Drama,Fantasy",Action,"['Drama', 'Fantasy']",10,2014,high,70000000,55991880,164249843,220241723,150241723,314.6310328571428
Godzilla,"Action,Adventure,Sci-Fi",Action,"['Adventure', 'Sci-Fi']",5,2014,high,160000000,200676069,328400000,529076069,369076069,330.672543125
Hotel Transylvania,"Animation,Comedy,Family",Animation,"['Comedy', 'Family']",9,2012,high,85000000,148313048,230192764,378505812,293505812,445.3009552941176
Pet Sematary,"Horror,Mystery,Thriller",Horror,"['Mystery', 'Thriller']",4,2019,mid,21000000,54724696,54776450,109501146,88501146,521.4340285714286
The Kids Are All Right,"Comedy,Drama,Romance",Comedy,"['Drama', 'Romance']",7,2010,low,4000000,20811365,15464104,36275469,32275469,906.8867250000001
The Avengers,"Action,Adventure,Sci-Fi",Action,"['Adventure', 'Sci-Fi']",5,2012,high,225000000,623279547,894656350,1517935897,1292935897,674.6381764444444
Epic,"Adventure,Animation,Family",Adventure,"['Animation', 'Family']",5,2013,high,100000000,107518682,155275759,262794441,162794441,262.794441
The Sweeney,"Action,Crime,Drama",Action,"['Crime', 'Drama']",3,2013,low,4500000,26345,7974021,8000366,3500366,177.78591111111112
Mr. Peabody & Sherman,"Adventure,Animation,Comedy",Adventure,"['Animation', 'Comedy']",3,2014,high,145000000,111506430,158300000,269806430,124806430,186.07340000000002
My Soul to Take,"Horror,Mystery,Thriller",Horror,"['Mystery', 'Thriller']",10,2010,mid,25000000,14744435,1983035,16727470,-8272530,66.90988
Red State,"Action,Crime,Horror",Action,"['Crime', 'Horror']",9,2011,low,4000000,1065429,918167,1983596,-2016404,49.5899
Please Give,"Comedy,Drama",Comedy,['Drama'],4,2010,low,3000000,4033574,536604,4570178,1570178,152.33926666666667
Eat Pray Love,"Drama,Romance",Drama,['Romance'],8,2010,high,60000000,80574010,126024779,206598789,146598789,344.33131499999996
Sanctum,"Adventure,Drama,Thriller",Adventure,"['Drama', 'Thriller']",2,2011,mid,30000000,23209310,85747788,108957098,78957098,363.1903266666667
Snitch,"Action,Drama,Thriller",Action,"['Drama', 'Thriller']",2,2013,mid,15000000,42930462,14977272,57907734,42907734,386.05156
The Wedding Ringer,Comedy,Comedy,[],1,2015,mid,23000000,64460211,15711385,80171596,57171596,348.57215652173915
The Switch,"Comedy,Drama,Romance",Comedy,"['Drama', 'Romance']",8,2010,mid,19000000,27758465,22100000,49858465,30858465,262.4129736842105
Letters to Juliet,"Adventure,Comedy,Drama",Adventure,"['Comedy', 'Drama']",5,2010,mid,30000000,53032453,29116085,82148538,52148538,273.82846
How to Train Your Dragon,"Action,Adventure,Animation",Action,"['Adventure', 'Animation']",3,2010,high,165000000,217581232,277289760,494870992,329870992,299.9218133333333
Shrek Forever After,"Adventure,Animation,Comedy",Adventure,"['Animation', 'Comedy']",5,2010,high,165000000,238736787,517507886,756244673,591244673,458.3301048484849
The Hobbit: An Unexpected Journey,"Adventure,Family,Fantasy",Adventure,"['Family', 'Fantasy']",12,2012,high,250000000,303003568,714000000,1017003568,767003568,406.80142720000003
The Legend of Tarzan,"Action,Adventure,Drama",Action,"['Adventure', 'Drama']",7,2016,high,180000000,126643061,222258964,348902025,168902025,193.83445833333332
Rabbit Hole,Drama,Drama,[],12,2010,mid,5000000,2229058,3975976,6205034,1205034,124.10068000000001
The Last Airbender,"Action,Adventure,Family",Action,"['Adventure', 'Family']",7,2010,high,150000000,131772187,187941694,319713881,169713881,213.14258733333332
Salt,"Action,Mystery,Thriller",Action,"['Mystery', 'Thriller']",7,2010,high,130000000,118311368,172339126,290650494,160650494,223.57730307692307
Source Code,"Action,Drama,Sci-Fi",Action,"['Drama', 'Sci-Fi']",4,2011,mid,32000000,54712227,85716272,140428499,108428499,438.839059375
Black Swan,"Drama,Thriller",Drama,['Thriller'],12,2010,mid,13000000,106954678,224312032,331266710,318266710,2548.205461538462
Green Zone,"Action,Drama,Thriller",Action,"['Drama', 'Thriller']",3,2010,high,100000000,35497337,62025683,97523020,-2476980,97.52302
The Amazing Spider-Man,"Action,Adventure,Sci-Fi",Action,"['Adventure', 'Sci-Fi']",7,2012,high,220000000,262030663,495859604,757890267,537890267,344.4955759090909
The Killer Inside Me,"Crime,Drama,Horror",Crime,"['Drama', 'Horror']",6,2010,mid,13000000,217277,3400000,3617277,-9382723,27.82520769230769
The Sorcerer's Apprentice,"Action,Adventure,Family",Action,"['Adventure', 'Family']",7,2010,high,160000000,63150991,154835329,217986320,57986320,136.24145000000001
The Fighter,"Biography,Drama,Sport",Biography,"['Drama', 'Sport']",12,2010,mid,11000000,93617009,35645379,129262388,118262388,1175.112618181818
Little Fockers,"Comedy,Romance",Comedy,['Romance'],12,2010,high,100000000,148438600,162211974,310650574,210650574,310.650574
Justice League,"Action,Adventure,Fantasy",Action,"['Adventure', 'Fantasy']",11,2017,high,300000000,229024295,426920914,655945209,355945209,218.648403
Sucker Punch,"Action,Adventure,Fantasy",Action,"['Adventure', 'Fantasy']",3,2011,high,75000000,36392502,53365887,89758389,14758389,119.677852
Lottery Ticket,Comedy,Comedy,[],8,2010,mid,17000000,24719879,0,24719879,7719879,145.41105294117648
The Chronicles of Narnia: The Voyage of the Dawn Treader,"Adventure,Family,Fantasy",Adventure,"['Family', 'Fantasy']",12,2010,high,155000000,104386950,313800000,418186950,263186950,269.7980322580645
The Adventures of Tintin,"Action,Adventure,Animation",Action,"['Adventure', 'Animation']",12,2011,high,130000000,77591831,296402120,373993951,243993951,287.68765461538464
Machete,"Action,Crime,Thriller",Action,"['Crime', 'Thriller']",9,2010,mid,12500000,26593646,19777324,46370970,33870970,370.96776
Dear John,"Drama,Romance,War",Drama,"['Romance', 'War']",2,2010,mid,25000000,80014842,62018667,142033509,117033509,568.134036
The Green Hornet,"Action,Comedy,Crime",Action,"['Comedy', 'Crime']",1,2011,high,110000000,98780042,130375461,229155503,119155503,208.32318454545455
Hanna,"Action,Drama,Thriller",Action,"['Drama', 'Thriller']",4,2011,mid,30000000,40259119,25084575,65343694,35343694,217.81231333333335
The Wolf of Wall Street,"Biography,Crime,Drama",Biography,"['Crime', 'Drama']",12,2013,high,100000000,116900694,272969720,389870414,289870414,389.870414
Straw Dogs,"Action,Drama,Thriller",Action,"['Drama', 'Thriller']",9,2011,mid,25000000,10324441,929380,11253821,-13746179,45.015284
Megamind,"Action,Animation,Comedy",Action,"['Animation', 'Comedy']",11,2010,high,130000000,148415853,173471355,321887208,191887208,247.6055446153846
The Young Messiah,"Drama,Fantasy",Drama,['Fantasy'],3,2016,mid,16800000,6469813,843884,7313697,-9486303,43.53391071428571
The Iron Lady,"Biography,Drama",Biography,['Drama'],1,2012,mid,14000000,29959436,85632668,115592104,101592104,825.6578857142857
Knight and Day,"Action,Adventure,Comedy",Action,"['Adventure', 'Comedy']",6,2010,high,117000000,76423035,182328335,258751370,141751370,221.15501709401707
Dylan Dog: Dead of Night,"Action,Comedy,Crime",Action,"['Comedy', 'Crime']",4,2011,mid,20000000,1186538,4907187,6093725,-13906275,30.468625
Child 44,"Crime,Drama,History",Crime,"['Drama', 'History']",4,2015,high,50000000,1224330,6779891,8004221,-41995779,16.008442000000002
The Sisterhood of Night,"Drama,Mystery,Thriller",Drama,"['Mystery', 'Thriller']",4,2015,low,1000000,6870,0,6870,-993130,0.687
Selma,"Biography,Drama,History",Biography,"['Drama', 'History']",1,2015,mid,20000000,52076908,14699668,66776576,46776576,333.88288
Centurion,"Action,Adventure,Drama",Action,"['Adventure', 'Drama']",8,2010,mid,15000000,123570,7761478,7885048,-7114952,52.56698666666667
Argo,"Biography,Drama,Thriller",Biography,"['Drama', 'Thriller']",10,2012,mid,44500000,136025503,91115254,227140757,182640757,510.42866741573033
Secretariat,"Biography,Drama,Family",Biography,"['Drama', 'Family']",10,2010,mid,35000000,59699513,676734,60376247,25376247,172.50356285714287
Poltergeist,"Horror,Thriller",Horror,['Thriller'],5,2015,mid,35000000,47425125,48287944,95713069,60713069,273.4659114285714
Hit & Run,"Action,Comedy",Action,['Comedy'],8,2012,mid,22000000,13749300,3467655,17216955,-4783045,78.25888636363636
The Warrior's Way,"Action,Fantasy,Western",Action,"['Fantasy', 'Western']",12,2010,mid,42000000,5666340,2847985,8514325,-33485675,20.272202380952383
Geroy,Action,Action,[],12,2015,mid,7000000,0,1545121,1545121,-5454879,22.07315714285714
Suspiria,"Fantasy,Horror,Mystery",Fantasy,"['Horror', 'Mystery']",10,2018,mid,20000000,2483472,4551143,7034615,-12965385,35.173075
The Book of Eli,"Action,Adventure,Drama",Action,"['Adventure', 'Drama']",1,2010,high,80000000,94835059,63915758,158750817,78750817,198.43852125
Legion,"Action,Fantasy,Horror",Action,"['Fantasy', 'Horror']",1,2010,mid,26000000,40168080,27479494,67647574,41647574,260.1829769230769
The Nutcracker in 3D,"Action,Family,Fantasy",Action,"['Family', 'Fantasy']",11,2010,high,90000000,195459,20270557,20466016,-69533984,22.740017777777776
The Legend of Hercules,"Action,Adventure,Fantasy",Action,"['Adventure', 'Fantasy']",1,2014,high,70000000,18848538,40104781,58953319,-11046681,84.21902714285714
Silver Linings Playbook,"Comedy,Drama,Romance",Comedy,"['Drama', 'Romance']",11,2012,mid,21000000,132092958,104319495,236412453,215412453,1125.7735857142857
Parental Guidance,"Comedy,Family",Comedy,['Family'],12,2012,mid,25000000,77267296,43565087,120832383,95832383,483.32953200000003
Goosebumps,"Adventure,Comedy,Family",Adventure,"['Comedy', 'Family']",10,2015,high,58000000,80069458,78835866,158905324,100905324,273.97469655172415
Repo Men,"Action,Crime,Sci-Fi",Action,"['Crime', 'Sci-Fi']",3,2010,mid,32000000,13942007,4253231,18195238,-13804762,56.86011875
The Big Year,Comedy,Comedy,[],10,2011,mid,41000000,7204138,480386,7684524,-33315476,18.74274146341463
Boyhood,Drama,Drama,[],7,2014,low,4000000,25379975,31893074,57273049,53273049,1431.826225
Water for Elephants,"Drama,Romance",Drama,['Romance'],4,2011,mid,38000000,58709717,58100000,116809717,78809717,307.3939921052632
Monte Carlo,"Adventure,Comedy,Family",Adventure,"['Comedy', 'Family']",7,2011,mid,20000000,23186769,16500000,39686769,19686769,198.43384500000002
Footloose,"Comedy,Drama,Music",Comedy,"['Drama', 'Music']",10,2011,mid,24000000,51802742,11187092,62989834,38989834,262.4576416666667
Ghost Rider: Spirit of Vengeance,"Action,Fantasy,Thriller",Action,"['Fantasy', 'Thriller']",2,2012,high,57000000,51774002,97443353,149217355,92217355,261.7848333333333
Winchester,"Biography,Drama,Fantasy",Biography,"['Drama', 'Fantasy']",2,2018,low,3500000,25091816,19286224,44378040,40878040,1267.944
Skyfall,"Action,Adventure,Thriller",Action,"['Adventure', 'Thriller']",11,2012,high,200000000,304360277,806166704,1110526981,910526981,555.2634905
Jonah Hex,"Action,Drama,Fantasy",Action,"['Drama', 'Fantasy']",6,2010,mid,47000000,10547117,475579,11022696,-35977304,23.452544680851066
Dark Shadows,"Comedy,Fantasy,Horror",Comedy,"['Fantasy', 'Horror']",5,2012,high,150000000,79727149,158475519,238202668,88202668,158.80177866666668
The Belko Experiment,"Horror,Thriller",Horror,['Thriller'],3,2017,mid,5000000,10166820,1626122,11792942,6792942,235.85884
Eddie the Eagle,"Biography,Comedy,Drama",Biography,"['Comedy', 'Drama']",2,2016,mid,23000000,15789389,29271091,45060480,22060480,195.9151304347826
Blended,"Comedy,Romance",Comedy,['Romance'],5,2014,mid,45000000,46290741,81700000,127990741,82990741,284.4238688888889
Lone Survivor,"Action,Biography,Drama",Action,"['Biography', 'Drama']",12,2013,mid,40000000,125095601,24709031,149804632,109804632,374.51158000000004
Ca$h,"Crime,Thriller",Crime,['Thriller'],3,2010,mid,7000000,46488,0,46488,-6953512,0.6641142857142857
Paddington,"Adventure,Comedy,Family",Adventure,"['Comedy', 'Family']",1,2015,high,55000000,76223578,182565519,258789097,203789097,470.52563090909086
Jackass 3D,"Action,Comedy,Documentary",Action,"['Comedy', 'Documentary']",10,2010,mid,20000000,117229692,54456101,171685793,151685793,858.4289650000001
Blue Valentine,"Drama,Romance",Drama,['Romance'],12,2010,low,1000000,9737892,6828348,16566240,15566240,1656.624
Seventh Son,"Action,Adventure,Fantasy",Action,"['Adventure', 'Fantasy']",2,2015,high,95000000,17725785,91149182,108874967,13874967,114.60522842105263
The Ides of March,"Drama,Thriller",Drama,['Thriller'],10,2011,mid,23000000,40962534,36773391,77735925,54735925,337.98228260869564
Free State of Jones,"Action,Biography,Drama",Action,"['Biography', 'Drama']",6,2016,high,50000000,20810036,2427216,23237252,-26762748,46.474504
Love Ranch,"Biography,Comedy,Drama",Biography,"['Comedy', 'Drama']",6,2010,mid,25000000,137885,8264,146149,-24853851,0.584596
Morning Glory,"Comedy,Drama,Romance",Comedy,"['Drama', 'Romance']",11,2010,mid,40000000,31011732,28783338,59795070,19795070,149.487675
Shutter Island,"Mystery,Thriller",Mystery,['Thriller'],2,2010,high,80000000,128012934,171448848,299461782,219461782,374.3272275
The 5th Quarter,"Biography,Drama,Sport",Biography,"['Drama', 'Sport']",3,2011,mid,6000000,408159,0,408159,-5591841,6.802650000000001
Green Lantern,"Action,Adventure,Sci-Fi",Action,"['Adventure', 'Sci-Fi']",6,2011,high,200000000,116601172,102934320,219535492,19535492,109.76774600000002
Takers,"Action,Crime,Thriller",Action,"['Crime', 'Thriller']",8,2010,mid,32000000,57744720,12842548,70587268,38587268,220.58521249999998
Death Wish,"Action,Crime,Drama",Action,"['Crime', 'Drama']",3,2018,mid,30000000,34017028,14558937,48575965,18575965,161.91988333333333
Accidental Love,"Comedy,Romance",Comedy,['Romance'],3,2015,mid,26000000,0,135436,135436,-25864564,0.5209076923076923
The Ghost Writer,"Drama,Mystery,Thriller",Drama,"['Mystery', 'Thriller']",2,2010,mid,45000000,15541549,49990942,65532491,20532491,145.6277577777778
Frankenweenie,"Animation,Comedy,Family",Animation,"['Comedy', 'Family']",10,2012,mid,39000000,35287788,45863000,81150788,42150788,208.07894358974357
Beastly,"Drama,Fantasy,Romance",Drama,"['Fantasy', 'Romance']",3,2011,mid,17000000,27865571,10162659,38028230,21028230,223.69547058823528
Freakonomics,Documentary,Documentary,[],10,2010,low,2900000,101270,71597,172867,-2727133,5.960931034482759
The Karate Kid,"Action,Drama,Family",Action,"['Drama', 'Family']",6,2010,mid,40000000,176591618,175183320,351774938,311774938,879.437345
The Rite,"Drama,Horror,Mystery",Drama,"['Horror', 'Mystery']",1,2011,mid,37000000,33047633,64096354,97143987,60143987,262.5513162162162
Biutiful,"Drama,Romance",Drama,['Romance'],1,2011,mid,35000000,5101237,19586287,24687524,-10312476,70.53578285714286
The Hobbit: The Desolation of Smaug,"Adventure,Fantasy",Adventure,['Fantasy'],12,2013,high,250000000,258366855,702000000,960366855,710366855,384.14674199999996
Baggage Claim,Comedy,Comedy,[],9,2013,mid,8500000,21569509,1316327,22885836,14385836,269.2451294117647
All Good Things,"Crime,Drama,Mystery",Crime,"['Drama', 'Mystery']",12,2010,mid,20000000,582024,291593,873617,-19126383,4.368085
A Walk in the Woods,"Adventure,Biography,Comedy",Adventure,"['Biography', 'Comedy']",9,2015,mid,8000000,29499394,7619964,37119358,29119358,463.99197499999997
A Nightmare on Elm Street,"Crime,Drama,Horror",Crime,"['Drama', 'Horror']",4,2010,mid,35000000,63075011,54654610,117729621,82729621,336.3703457142857
10 Cloverfield Lane,"Drama,Horror,Mystery",Drama,"['Horror', 'Mystery']",3,2016,mid,5000000,72082999,36203423,108286422,103286422,2165.7284400000003
You Will Meet a Tall Dark Stranger,"Comedy,Drama,Romance",Comedy,"['Drama', 'Romance']",9,2010,mid,15000000,3247816,31000000,34247816,19247816,228.31877333333335
Welcome to the Rileys,Drama,Drama,[],10,2010,mid,10000000,152857,203062,355919,-9644081,3.55919
The Lincoln Lawyer,"Crime,Drama,Thriller",Crime,"['Drama', 'Thriller']",3,2011,mid,40000000,58009200,29135886,87145086,47145086,217.862715
Rango,"Adventure,Animation,Comedy",Adventure,"['Animation', 'Comedy']",3,2011,high,135000000,123477607,122246993,245724600,110724600,182.01822222222222
Step Up 3D,"Drama,Music,Romance",Drama,"['Music', 'Romance']",8,2010,mid,30000000,42400223,123488894,165889117,135889117,552.9637233333333
The Bourne Legacy,"Action,Adventure,Thriller",Action,"['Adventure', 'Thriller']",8,2012,high,125000000,113203870,167152050,280355920,155355920,224.28473599999998
Casino Jack,"Biography,Comedy,Crime",Biography,"['Comedy', 'Crime']",12,2010,mid,12500000,2039869,232317,2272186,-10227814,18.177488
The Five-Year Engagement,"Comedy,Romance",Comedy,['Romance'],4,2012,mid,30000000,28700285,32923534,61623819,31623819,205.41273
Diary of a Wimpy Kid,"Comedy,Drama,Family",Comedy,"['Drama', 'Family']",3,2010,mid,15000000,64003625,12950686,76954311,61954311,513.02874
Kites,"Action,Drama,Romance",Action,"['Drama', 'Romance']",5,2010,mid,9200000,1685269,15469924,17155193,7955193,186.46948913043477
The Muppets,"Adventure,Comedy,Family",Adventure,"['Comedy', 'Family']",11,2011,mid,45000000,88625922,72346000,160971922,115971922,357.7153822222222
Last Vegas,"Comedy,Drama",Comedy,['Drama'],1,2013,mid,28000000,63914167,49000000,112914167,84914167,403.2648821428571
Ouija,"Horror,Mystery,Thriller",Horror,"['Mystery', 'Thriller']",10,2014,mid,5000000,50856010,52444622,103300632,98300632,2066.01264
Jack Ryan: Shadow Recruit,"Action,Drama,Thriller",Action,"['Drama', 'Thriller']",1,2014,high,60000000,50577412,80800000,131377412,71377412,218.9623533333333
Out of the Furnace,"Crime,Drama,Thriller",Crime,"['Drama', 'Thriller']",12,2013,mid,22000000,11330849,4103526,15434375,-6565625,70.15625
Blood Done Sign My Name,Drama,Drama,[],2,2010,mid,10000000,109383,0,109383,-9890617,1.09383
Moneyball,"Biography,Drama,Sport",Biography,"['Drama', 'Sport']",9,2011,high,50000000,75605492,35695343,111300835,61300835,222.60167
The Lone Ranger,"Action,Adventure,Western",Action,"['Adventure', 'Western']",7,2013,high,275000000,89302115,170700000,260002115,-14997885,94.54622363636364
Doctor Strange,"Action,Adventure,Fantasy",Action,"['Adventure', 'Fantasy']",11,2016,high,165000000,232641920,443762646,676404566,511404566,409.94216121212116
Middle of Nowhere,Drama,Drama,[],10,2012,low,200000,236806,0,236806,36806,118.40299999999999
Escape Plan,"Action,Crime,Mystery",Action,"['Crime', 'Mystery']",10,2013,high,70000000,25135965,78600000,103735965,33735965,148.19423571428572
Hereafter,"Drama,Fantasy,Romance",Drama,"['Fantasy', 'Romance']",10,2010,high,50000000,32746941,75913329,108660270,58660270,217.32054
The Lost City of Z,"Adventure,Biography,Drama",Adventure,"['Biography', 'Drama']",4,2017,mid,30000000,8574339,8547484,17121823,-12878177,57.07274333333333
The Back-up Plan,"Comedy,Romance",Comedy,['Romance'],4,2010,mid,35000000,37490007,37791172,75281179,40281179,215.08908285714287
The World's End,"Action,Comedy,Sci-Fi",Action,"['Comedy', 'Sci-Fi']",8,2013,mid,20000000,26004851,21503654,47508505,27508505,237.542525
Cars 2,"Adventure,Animation,Comedy",Adventure,"['Animation', 'Comedy']",6,2011,high,200000000,191450875,368704508,560155383,360155383,280.0776915
Kill the Messenger,"Biography,Crime,Drama",Biography,"['Crime', 'Drama']",10,2014,mid,5000000,2450846,4205859,6656705,1656705,133.13410000000002
Legend of the Guardians: The Owls of Ga'Hoole,"Action,Adventure,Animation",Action,"['Adventure', 'Animation']",9,2010,high,100000000,55675313,84041404,139716717,39716717,139.716717
Ghost in the Shell,"Action,Drama,Sci-Fi",Action,"['Drama', 'Sci-Fi']",3,2017,high,110000000,40563557,127347133,167910690,57910690,152.6460818181818
Resident Evil: Afterlife,"Action,Adventure,Horror",Action,"['Adventure', 'Horror']",9,2010,high,57500000,60128566,235745624,295874190,238374190,514.5638086956521
Zookeeper,"Comedy,Family,Romance",Comedy,"['Family', 'Romance']",7,2011,high,80000000,80360866,90444659,170805525,90805525,213.50690625
Viy,"Adventure,Fantasy,Mystery",Adventure,"['Fantasy', 'Mystery']",6,2015,mid,26000000,0,34246770,34246770,8246770,131.71834615384614
Get Him to the Greek,"Adventure,Comedy,Music",Adventure,"['Comedy', 'Music']",6,2010,mid,40000000,61153526,30302349,91455875,51455875,228.63968749999998
Edge of Darkness,"Crime,Drama,Mystery",Crime,"['Drama', 'Mystery']",1,2010,high,60000000,43313890,39498566,82812456,22812456,138.02076
Iron Man 2,"Action,Adventure,Sci-Fi",Action,"['Adventure', 'Sci-Fi']",5,2010,high,170000000,312433331,308723058,621156389,451156389,365.3861111764706
Anchorman 2: The Legend Continues,Comedy,Comedy,[],12,2013,high,50000000,127352707,44833047,172185754,122185754,344.371508
Same Kind of Different as Me,"Biography,Drama",Biography,['Drama'],10,2017,mid,6500000,6423605,0,6423605,-76395,98.8246923076923
Due Date,"Adventure,Comedy",Adventure,['Comedy'],11,2010,high,65000000,100539043,111200000,211739043,146739043,325.75237384615383
Hot Tub Time Machine,"Comedy,Sci-Fi",Comedy,['Sci-Fi'],3,2010,mid,36000000,50269859,15697891,65967750,29967750,183.24375
That's My Boy,Comedy,Comedy,[],6,2012,high,57500000,36931089,21154146,58085235,585235,101.01780000000001
21 Jump Street,"Action,Comedy,Crime",Action,"['Comedy', 'Crime']",3,2012,mid,42000000,138447667,64364762,202812429,160812429,482.88673571428575
Brighton Rock,"Crime,Drama,Thriller",Crime,"['Drama', 'Thriller']",8,2011,mid,11000000,229653,0,229653,-10770347,2.0877545454545454
Ironclad,"Action,Adventure,Drama",Action,"['Adventure', 'Drama']",7,2011,mid,25000000,0,5297411,5297411,-19702589,21.189643999999998
Red Dawn,"Action,Sci-Fi,Thriller",Action,"['Sci-Fi', 'Thriller']",11,2012,high,65000000,44806783,3357367,48164150,-16835850,74.0986923076923
RoboCop,"Action,Crime,Sci-Fi",Action,"['Crime', 'Sci-Fi']",2,2014,high,120000000,58607007,184374792,242981799,122981799,202.48483249999998
The Future,"Drama,Fantasy,Romance",Drama,"['Fantasy', 'Romance']",7,2011,low,1000000,568662,670512,1239174,239174,123.9174
Wild Target,"Action,Comedy,Crime",Action,"['Comedy', 'Crime']",10,2010,mid,8000000,109338,5204856,5314194,-2685806,66.427425
Broken City,"Crime,Drama,Thriller",Crime,"['Drama', 'Thriller']",1,2013,mid,35000000,19701164,14778881,34480045,-519955,98.5144142857143
Your Highness,"Adventure,Comedy,Fantasy",Adventure,"['Comedy', 'Fantasy']",4,2011,high,50000000,21596445,4525193,26121638,-23878362,52.24327600000001
Locker 13,Thriller,Thriller,[],3,2014,low,300000,3496,0,3496,-296504,1.1653333333333333
I Spit on Your Grave,"Horror,Thriller",Horror,['Thriller'],10,2010,low,1750000,93051,1185420,1278471,-471529,73.05548571428572
We Need to Talk About Kevin,"Drama,Mystery,Thriller",Drama,"['Mystery', 'Thriller']",1,2012,mid,7000000,1738692,9026591,10765283,3765283,153.78975714285716
The Tourist,"Action,Adventure,Thriller",Action,"['Adventure', 'Thriller']",12,2010,high,100000000,67631157,211100212,278731369,178731369,278.731369
Aloha,"Comedy,Drama,Romance",Comedy,"['Drama', 'Romance']",5,2015,mid,37000000,21052030,4335061,25387091,-11612909,68.61375945945946
Extraordinary Measures,Drama,Drama,[],1,2010,mid,31000000,12482741,3344243,15826984,-15173016,51.05478709677419
High School,Comedy,Comedy,[],6,2012,mid,10000000,139034,109099,248133,-9751867,2.48133
Kick-Ass,"Action,Comedy",Action,['Comedy'],4,2010,mid,28000000,48071303,49459831,97531134,69531134,348.32547857142856
Salvation Boulevard,"Action,Comedy,Drama",Action,"['Comedy', 'Drama']",7,2011,mid,5500000,28468,0,28468,-5471532,0.5176000000000001
300: Rise of an Empire,"Action,Fantasy,War",Action,"['Fantasy', 'War']",3,2014,high,110000000,106580051,224200000,330780051,220780051,300.7091372727273
Immortals,"Action,Drama,Fantasy",Action,"['Drama', 'Fantasy']",11,2011,high,75000000,83504017,128058418,211562435,136562435,282.0832466666667
Holmes & Watson,"Adventure,Comedy,Crime",Adventure,"['Comedy', 'Crime']",12,2018,mid,42000000,30568743,11357862,41926605,-73395,99.82525
Incendies,"Drama,Mystery,War",Drama,"['Mystery', 'War']",9,2010,mid,6800000,6857096,9181247,16038343,9238343,235.85798529411767
The Man with the Iron Fists,Action,Action,[],11,2012,mid,15000000,15634090,6384898,22018988,7018988,146.79325333333333
The Cabin in the Woods,Horror,Horror,[],4,2012,mid,30000000,42073277,28616691,70689968,40689968,235.63322666666667
Den of Thieves,"Action,Crime,Drama",Action,"['Crime', 'Drama']",1,2018,mid,30000000,44947622,35183769,80131391,50131391,267.1046366666667
Sex and the City 2,"Comedy,Drama,Romance",Comedy,"['Drama', 'Romance']",5,2010,high,95000000,95347692,199333086,294680778,199680778,310.1902926315789
Scream 4,"Horror,Mystery",Horror,['Mystery'],4,2011,mid,40000000,38180928,57808662,95989590,55989590,239.97397500000002
The Roommate,"Drama,Thriller",Drama,['Thriller'],2,2011,mid,16000000,37300107,15245600,52545707,36545707,328.41066875
A Very Harold & Kumar 3D Christmas,"Adventure,Comedy",Adventure,['Comedy'],11,2011,mid,20000000,35061031,1204714,36265745,16265745,181.328725
The Devil's Double,"Biography,Drama,Thriller",Biography,"['Drama', 'Thriller']",7,2011,mid,19100000,1361512,4604134,5965646,-13134354,31.23374869109948
Don't Be Afraid of the Dark,"Fantasy,Horror,Thriller",Fantasy,"['Horror', 'Thriller']",8,2011,mid,25000000,24046682,15079745,39126427,14126427,156.505708
X-Men: First Class,"Action,Adventure,Sci-Fi",Action,"['Adventure', 'Sci-Fi']",6,2011,high,160000000,146408305,209000000,355408305,195408305,222.13019062499998
2 Guns,"Action,Comedy,Crime",Action,"['Comedy', 'Crime']",8,2013,high,61000000,75612460,56880555,132493015,71493015,217.20166393442622
London Fields,"Crime,Mystery,Thriller",Crime,"['Mystery', 'Thriller']",10,2018,mid,8000000,252676,181056,433732,-7566268,5.42165
The Spy Next Door,"Action,Comedy,Family",Action,"['Comedy', 'Family']",1,2010,mid,28000000,24307106,22445752,46752858,18752858,166.97449285714285
Dying of the Light,"Drama,Thriller",Drama,['Thriller'],12,2014,mid,5000000,0,74639,74639,-4925361,1.49278
Looper,"Action,Crime,Drama",Action,"['Crime', 'Drama']",9,2012,mid,30000000,66486205,103980200,170466405,140466405,568.2213499999999
Madagascar 3: Europe's Most Wanted,"Adventure,Animation,Comedy",Adventure,"['Animation', 'Comedy']",6,2012,high,145000000,216391482,530529789,746921271,601921271,515.1181179310345
Date Night,"Comedy,Crime,Romance",Comedy,"['Crime', 'Romance']",4,2010,high,55000000,98711404,53557629,152269033,97269033,276.8527872727273
Fort McCoy,"Drama,History,War",Drama,"['History', 'War']",8,2014,low,3000000,78948,0,78948,-2921052,2.6315999999999997
Easy A,"Comedy,Drama,Romance",Comedy,"['Drama', 'Romance']",9,2010,mid,8000000,58401464,17799257,76200721,68200721,952.5090125
Bad Teacher,"Comedy,Romance",Comedy,['Romance'],6,2011,mid,19000000,100292856,115156141,215448997,196448997,1133.942089473684
The Strangers: Prey at Night,Horror,Horror,[],3,2018,mid,5000000,24431472,5528579,29960051,24960051,599.20102
The Social Network,"Biography,Drama",Biography,['Drama'],10,2010,mid,40000000,96962694,127959441,224922135,184922135,562.3053375
Cats & Dogs: The Revenge of Kitty Galore,"Action,Comedy,Family",Action,"['Comedy', 'Family']",7,2010,high,85000000,43585753,69440630,113026383,28026383,132.97221529411763
Evil Dead,"Fantasy,Horror,Thriller",Fantasy,"['Horror', 'Thriller']",4,2013,mid,17000000,54239856,43538500,97778356,80778356,575.1668
Ghostbusters,"Action,Comedy,Fantasy",Action,"['Comedy', 'Fantasy']",7,2016,high,144000000,128350574,100658084,229008658,85008658,159.03379027777777
N-Secure,"Crime,Drama,Thriller",Crime,"['Drama', 'Thriller']",10,2010,low,1600000,2595644,0,2595644,995644,162.22775000000001
Teenage Mutant Ninja Turtles,"Action,Adventure,Comedy",Action,"['Adventure', 'Comedy']",8,2014,high,125000000,191204754,293800000,485004754,360004754,388.0038032
xXx: Return of Xander Cage,"Action,Adventure,Thriller",Action,"['Adventure', 'Thriller']",1,2017,high,85000000,44898413,300134946,345033359,260033359,405.92159882352945
The Last Song,"Drama,Music,Romance",Drama,"['Music', 'Romance']",3,2010,mid,20000000,62950384,29728564,92678948,72678948,463.39474
The Watch,"Action,Comedy,Horror",Action,"['Comedy', 'Horror']",7,2012,high,55000000,34353000,32777045,67130045,12130045,122.05462727272727
Pirates of the Caribbean: On Stranger Tides,"Action,Adventure,Fantasy",Action,"['Adventure', 'Fantasy']",5,2011,high,410600000,241063875,804600000,1045663875,635063875,254.6672856794934
Iron Man 3,"Action,Adventure,Sci-Fi",Action,"['Adventure', 'Sci-Fi']",5,2013,high,200000000,408992272,806400000,1215392272,1015392272,607.696136
Kung Fu Panda 2,"Action,Adventure,Animation",Action,"['Adventure', 'Animation']",5,2011,high,150000000,165249063,499588484,664837547,514837547,443.22503133333333
Yogi Bear,"Adventure,Animation,Comedy",Adventure,"['Animation', 'Comedy']",12,2010,high,80000000,100246011,104528679,204774690,124774690,255.96836249999998
Standing Ovation,Musical,Musical,[],7,2010,mid,5600000,531806,0,531806,-5068194,9.496535714285715
Our Family Wedding,"Comedy,Romance",Comedy,['Romance'],3,2010,mid,14000000,20255281,1155265,21410546,7410546,152.93247142857143
Mars Needs Moms,"Adventure,Animation,Family",Adventure,"['Animation', 'Family']",3,2011,high,150000000,21392758,18157000,39549758,-110450242,26.366505333333336
Seeking a Friend for the End of the World,"Adventure,Comedy,Drama",Adventure,"['Comedy', 'Drama']",6,2012,mid,10000000,7078738,4688221,11766959,1766959,117.66958999999999
Bullet to the Head,"Action,Crime,Thriller",Action,"['Crime', 'Thriller']",2,2013,high,55000000,9489829,13108140,22597969,-32402031,41.087216363636365
3 Backyards,Drama,Drama,[],3,2011,low,300000,39475,0,39475,-260525,13.158333333333333
There Be Dragons,"Biography,Drama,War",Biography,"['Drama', 'War']",5,2011,mid,36000000,1069334,2951656,4020990,-31979010,11.169416666666667
Rise of the Planet of the Apes,"Action,Drama,Sci-Fi",Action,"['Drama', 'Sci-Fi']",8,2011,high,93000000,176760185,294226015,470986200,377986200,506.43677419354833
It's a Wonderful Afterlife,"Comedy,Drama,Fantasy",Comedy,"['Drama', 'Fantasy']",10,2010,mid,10000000,0,1642939,1642939,-8357061,16.429389999999998
The Last Exorcism,"Drama,Horror,Thriller",Drama,"['Horror', 'Thriller']",8,2010,low,1800000,41034350,29131550,70165900,68365900,3898.105555555556
The Expendables,"Action,Adventure,Thriller",Action,"['Adventure', 'Thriller']",8,2010,high,82000000,103068524,165199650,268268174,186268174,327.1563097560976
Gulliver's Travels,"Adventure,Comedy,Family",Adventure,"['Comedy', 'Family']",12,2010,high,112000000,42779261,189238587,232017848,120017848,207.15879285714288
The Reef,"Adventure,Drama,Horror",Adventure,"['Drama', 'Horror']",12,2010,mid,10000000,0,15037867,15037867,5037867,150.37867
Death at a Funeral,Comedy,Comedy,[],4,2010,mid,21000000,42739347,6237886,48977233,27977233,233.22491904761904
The Beaver,Drama,Drama,[],5,2011,mid,21000000,970816,4075222,5046038,-15953962,24.02875238095238
Gangster Squad,"Action,Crime,Drama",Action,"['Crime', 'Drama']",1,2013,high,60000000,46000903,58100000,104100903,44100903,173.50150499999998
August: Osage County,"Comedy,Drama",Comedy,['Drama'],12,2013,mid,25000000,37738810,13000000,50738810,25738810,202.95524
Despicable Me,"Animation,Comedy,Family",Animation,"['Comedy', 'Family']",7,2010,high,69000000,251513985,291950588,543464573,474464573,787.6298159420289
The Twilight Saga: Eclipse,"Adventure,Drama,Fantasy",Adventure,"['Drama', 'Fantasy']",6,2010,high,68000000,300531751,405571077,706102828,638102828,1038.3865117647058
The Lucky One,"Drama,Romance",Drama,['Romance'],4,2012,mid,25000000,60457138,36176695,96633833,71633833,386.535332
Lee Daniels' The Butler,"Biography,Drama",Biography,['Drama'],8,2013,mid,30000000,116632095,60393403,177025498,147025498,590.0849933333334
Movie 43,Comedy,Comedy,[],1,2013,mid,10000000,8840453,22324294,31164747,21164747,311.64747
Arthur,"Comedy,Romance",Comedy,['Romance'],4,2011,mid,40000000,33035397,14752546,47787943,7787943,119.4698575
47 Ronin,"Action,Adventure,Drama",Action,"['Adventure', 'Drama']",12,2013,high,175000000,38362475,113354340,151716815,-23283185,86.69532285714286
Rock of Ages,"Comedy,Drama,Musical",Comedy,"['Drama', 'Musical']",6,2012,high,70000000,38518613,22513319,61031932,-8968068,87.18847428571429
Cyrus,"Comedy,Drama,Romance",Comedy,"['Drama', 'Romance']",6,2010,mid,7000000,7468936,2593960,10062896,3062896,143.75565714285713
Tinker Tailor Soldier Spy,"Drama,Mystery,Thriller",Drama,"['Mystery', 'Thriller']",12,2011,mid,21000000,24149393,57303418,81452811,60452811,387.87052857142857
Four Lions,"Comedy,Crime,Drama",Comedy,"['Crime', 'Drama']",11,2010,low,3750000,310007,2126104,2436111,-1313889,64.96296000000001
The Great Gatsby,"Drama,Romance",Drama,['Romance'],5,2013,high,190000000,144840419,206200000,351040419,161040419,184.7581152631579
Dredd,"Action,Crime,Sci-Fi",Action,"['Crime', 'Sci-Fi']",9,2012,mid,45000000,13414714,28052892,41467606,-3532394,92.15023555555555
The Dark Knight Rises,"Action,Thriller",Action,['Thriller'],7,2012,high,275000000,448139099,636300000,1084439099,809439099,394.3414905454545
Jack the Giant Slayer,"Adventure,Fantasy",Adventure,['Fantasy'],3,2013,high,195000000,65187603,132500000,197687603,2687603,101.37825794871796
If I Stay,"Drama,Fantasy,Music",Drama,"['Fantasy', 'Music']",8,2014,mid,11000000,50474843,27881327,78356170,67356170,712.3288181818182
The Infiltrator,"Biography,Crime,Drama",Biography,"['Crime', 'Drama']",7,2016,mid,47500000,15436808,5281296,20718104,-26781896,43.61706105263158
Passengers,"Drama,Romance,Sci-Fi",Drama,"['Romance', 'Sci-Fi']",12,2016,high,110000000,100014699,202224973,302239672,192239672,274.7633381818182
Black Mass,"Biography,Crime,Drama",Biography,"['Crime', 'Drama']",9,2015,high,53000000,62575678,36262194,98837872,45837872,186.48655094339622
The Extra Man,Comedy,Comedy,[],7,2010,mid,7000000,453377,38731,492108,-6507892,7.030114285714285
Tomb Raider,"Action,Adventure,Fantasy",Action,"['Adventure', 'Fantasy']",3,2018,high,90000000,58250803,215226698,273477501,183477501,303.86389
Lowriders,"Adventure,Crime,Drama",Adventure,"['Crime', 'Drama']",5,2017,low,916000,6179955,8466,6188421,5272421,675.5918122270742
The Cold Light of Day,"Action,Thriller",Action,['Thriller'],9,2012,mid,20000000,3763583,21597623,25361206,5361206,126.80602999999999
Cloud Atlas,"Action,Drama,Mystery",Action,"['Drama', 'Mystery']",10,2012,high,102000000,27108272,103564882,130673154,28673154,128.11093529411767
Made in Dagenham,"Biography,Comedy,Drama",Biography,"['Comedy', 'Drama']",11,2010,mid,8000000,1095369,14548827,15644196,7644196,195.55245000000002
Pride and Prejudice and Zombies,"Action,Comedy,Horror",Action,"['Comedy', 'Horror']",2,2016,mid,28000000,10907291,5731009,16638300,-11361700,59.4225
Inception,"Action,Adventure,Sci-Fi",Action,"['Adventure', 'Sci-Fi']",7,2010,high,160000000,292576195,542948447,835524642,675524642,522.20290125
Grown Ups,Comedy,Comedy,[],6,2010,high,75000000,162001186,110222244,272223430,197223430,362.9645733333333
Gunless,"Action,Comedy,Drama",Action,"['Comedy', 'Drama']",4,2010,mid,9900000,458054,0,458054,-9441946,4.626808080808081
The Adjustment Bureau,"Romance,Sci-Fi,Thriller",Romance,"['Sci-Fi', 'Thriller']",3,2011,high,50200000,62495645,64435680,126931325,76731325,252.85124501992033
Cop Out,"Action,Comedy,Crime",Action,"['Comedy', 'Crime']",2,2010,mid,37000000,44875481,11034429,55909910,18909910,151.10786486486487
The Other Guys,"Action,Comedy,Crime",Action,"['Comedy', 'Crime']",8,2010,high,100000000,119219978,51716492,170936470,70936470,170.93647
Suicide Squad,"Action,Adventure,Fantasy",Action,"['Adventure', 'Fantasy']",8,2016,high,175000000,325100054,420959833,746059887,571059887,426.31993542857145
Downsizing,"Drama,Sci-Fi",Drama,['Sci-Fi'],12,2017,high,68000000,24449754,30013217,54462971,-13537029,80.0926044117647
We Bought a Zoo,"Comedy,Drama,Family",Comedy,"['Drama', 'Family']",12,2011,high,50000000,75624550,43104523,118729073,68729073,237.458146
In the Heart of the Sea,"Action,Adventure,Biography",Action,"['Adventure', 'Biography']",12,2015,high,100000000,25020758,64672551,89693309,-10306691,89.693309
The Lost Medallion: The Adventures of Billy Stone,"Adventure,Family,Fantasy",Adventure,"['Family', 'Fantasy']",3,2013,low,2500000,549632,0,549632,-1950368,21.98528
Why Did I Get Married Too?,"Comedy,Drama,Romance",Comedy,"['Drama', 'Romance']",4,2010,mid,20000000,60095852,735215,60831067,40831067,304.155335
The Hunger Games,"Action,Adventure,Sci-Fi",Action,"['Adventure', 'Sci-Fi']",3,2012,high,80000000,408010692,269912687,677923379,597923379,847.40422375
Mad Max: Fury Road,"Action,Adventure,Sci-Fi",Action,"['Adventure', 'Sci-Fi']",5,2015,high,150000000,153636354,216461666,370098020,220098020,246.73201333333333
Marmaduke,"Comedy,Family",Comedy,['Family'],6,2010,high,50000000,33644788,56251142,89895930,39895930,179.79186
Prisoners,"Crime,Drama,Mystery",Crime,"['Drama', 'Mystery']",9,2013,mid,46000000,61002302,52400000,113402302,67402302,246.5267434782609
It,"Horror,Thriller",Horror,['Thriller'],9,2017,mid,35000000,327481748,369976221,697457969,662457969,1992.7370542857143
Taken 2,"Action,Thriller",Action,['Thriller'],10,2012,mid,45000000,139854287,237953117,377807404,332807404,839.5720088888888
Journey 2: The Mysterious Island,"Action,Adventure,Comedy",Action,"['Adventure', 'Comedy']",2,2012,high,79000000,103860290,214285872,318146162,239146162,402.71666075949366
Straight Outta Compton,"Biography,Drama,History",Biography,"['Drama', 'History']",8,2015,mid,28000000,161197785,40985196,202182981,174182981,722.0820749999999
Transformers: Dark of the Moon,"Action,Adventure,Sci-Fi",Action,"['Adventure', 'Sci-Fi']",6,2011,high,195000000,352390543,771400000,1123790543,928790543,576.3028425641025
Winter's Bone,"Drama,Mystery",Drama,['Mystery'],6,2010,low,2000000,6531503,9600048,16131551,14131551,806.5775500000001
Happy Feet Two,"Adventure,Animation,Comedy",Adventure,"['Animation', 'Comedy']",11,2011,high,135000000,64006466,93950000,157956466,22956466,117.00478962962964
Hesher,"Comedy,Crime,Drama",Comedy,"['Crime', 'Drama']",5,2011,mid,7000000,382946,0,382946,-6617054,5.470657142857143
True Grit,"Adventure,Drama,Western",Adventure,"['Drama', 'Western']",12,2010,mid,35000000,171243005,81033923,252276928,217276928,720.7912228571429
For Colored Girls,Drama,Drama,[],11,2010,mid,21000000,37729698,288175,38017873,17017873,181.03749047619047
Just Wright,"Comedy,Romance,Sport",Comedy,"['Romance', 'Sport']",5,2010,mid,12000000,21540363,327302,21867665,9867665,182.23054166666665
Star Trek Into Darkness,"Action,Adventure,Sci-Fi",Action,"['Adventure', 'Sci-Fi']",5,2013,high,190000000,228778661,238602923,467381584,277381584,245.99030736842104
Men in Black 3,"Action,Adventure,Comedy",Action,"['Adventure', 'Comedy']",5,2012,high,215000000,179020854,475192631,654213485,439213485,304.2853418604651
Riddick,"Action,Adventure,Sci-Fi",Action,"['Adventure', 'Sci-Fi']",9,2013,mid,38000000,42025135,52738623,94763758,56763758,249.37831052631577
Bucky Larson: Born to Be a Star,Comedy,Comedy,[],9,2011,mid,10000000,2529395,0,2529395,-7470605,25.29395
The Hangover Part II,"Comedy,Mystery",Comedy,['Mystery'],5,2011,high,80000000,254464305,332000000,586464305,506464305,733.08038125
Hop,"Adventure,Animation,Comedy",Adventure,"['Animation', 'Comedy']",4,2011,high,63000000,108085305,80572288,188657593,125657593,299.4564968253968
The Best Exotic Marigold Hotel,"Comedy,Drama,Romance",Comedy,"['Drama', 'Romance']",5,2012,mid,10000000,46383639,88256141,134639780,124639780,1346.3978
Table 19,"Comedy,Drama,Romance",Comedy,"['Drama', 'Romance']",3,2017,mid,5000000,3614896,1005503,4620399,-379601,92.40798
12 Strong,"Action,Drama,History",Action,"['Drama', 'History']",1,2018,mid,35000000,45819713,25298665,71118378,36118378,203.1953657142857
Tracker,"Action,Adventure,Drama",Action,"['Adventure', 'Drama']",12,2011,mid,6500000,0,3149,3149,-6496851,0.04844615384615385
You Again,"Comedy,Family,Romance",Comedy,"['Family', 'Romance']",9,2010,mid,20000000,25702053,7136892,32838945,12838945,164.194725
"I, Frankenstein","Action,Fantasy,Horror",Action,"['Fantasy', 'Horror']",1,2014,high,65000000,19075290,55500000,74575290,9575290,114.7312153846154
Beneath Hill 60,"Drama,History,War",Drama,"['History', 'War']",6,2014,mid,9000000,0,3440939,3440939,-5559061,38.23265555555555
Somewhere,"Comedy,Drama",Comedy,['Drama'],12,2010,mid,7000000,1785645,15237476,17023121,10023121,243.18744285714286
A Lonely Place to Die,"Adventure,Crime,Thriller",Adventure,"['Crime', 'Thriller']",3,2012,low,4000000,0,442550,442550,-3557450,11.06375
Barney's Version,"Comedy,Drama",Comedy,['Drama'],1,2011,mid,30000000,7502560,1343015,8845575,-21154425,29.48525
Predators,"Action,Adventure,Sci-Fi",Action,"['Adventure', 'Sci-Fi']",7,2010,mid,40000000,52000688,75233701,127234389,87234389,318.08597249999997
Black Nativity,"Drama,Family,Music",Drama,"['Family', 'Music']",11,2013,mid,17500000,7018188,266947,7285135,-10214865,41.62934285714286
Hansel & Gretel: Witch Hunters,"Action,Fantasy,Horror",Action,"['Fantasy', 'Horror']",1,2013,high,50000000,55703475,159246241,214949716,164949716,429.89943200000005
The Wolverine,"Action,Adventure,Sci-Fi",Action,"['Adventure', 'Sci-Fi']",7,2013,high,115000000,132556852,283900000,416456852,301456852,362.1363930434783
Arthur Christmas,"Adventure,Animation,Comedy",Adventure,"['Animation', 'Comedy']",11,2011,high,85000000,46462469,103254655,149717124,64717124,176.13779294117646
Brick Mansions,"Action,Crime",Action,['Crime'],4,2014,mid,28000000,20396829,53024395,73421224,45421224,262.2186571428571
Big Miracle,"Biography,Drama,Family",Biography,"['Drama', 'Family']",2,2012,mid,40000000,20157300,5111380,25268680,-14731320,63.171699999999994
The Pirates! Band of Misfits,"Adventure,Animation,Comedy",Adventure,"['Animation', 'Comedy']",4,2012,high,55000000,31051126,105092479,136143605,81143605,247.53382727272725
Deadpool,"Action,Adventure,Comedy",Action,"['Adventure', 'Comedy']",2,2016,high,58000000,363070709,437954884,801025593,743025593,1381.0786086206897
Faster,"Action,Crime,Drama",Action,"['Crime', 'Drama']",11,2010,mid,24000000,23240020,12552925,35792945,11792945,149.13727083333333
Fright Night,"Comedy,Horror",Comedy,['Horror'],8,2011,mid,30000000,18298649,22222000,40520649,10520649,135.06883000000002
Charlie St. Cloud,"Drama,Fantasy,Romance",Drama,"['Fantasy', 'Romance']",7,2010,mid,44000000,31206263,17271821,48478084,4478084,110.17746363636363
Battleship,"Action,Adventure,Sci-Fi",Action,"['Adventure', 'Sci-Fi']",5,2012,high,220000000,65233400,248244317,313477717,93477717,142.48987136363635
A Little Bit of Heaven,"Comedy,Drama,Fantasy",Comedy,"['Drama', 'Fantasy']",5,2012,mid,12500000,10011,1090276,1100287,-11399713,8.802296
Submarine,"Comedy,Drama,Romance",Comedy,"['Drama', 'Romance']",6,2011,low,1900000,467602,4114335,4581937,2681937,241.1545789473684
The American,"Crime,Drama,Thriller",Crime,"['Drama', 'Thriller']",9,2010,mid,20000000,35606376,32344347,67950723,47950723,339.753615
Martha Marcy May Marlene,"Drama,Mystery,Thriller",Drama,"['Mystery', 'Thriller']",10,2011,low,1000000,2981038,2457873,5438911,4438911,543.8911
Under the Skin,"Drama,Horror,Sci-Fi",Drama,"['Horror', 'Sci-Fi']",4,2014,mid,13300000,2614251,4615682,7229933,-6070067,54.360398496240606
Quartet,"Comedy,Drama",Comedy,['Drama'],1,2013,mid,11000000,18388357,37790578,56178935,45178935,510.7175909090909
Testament of Youth,"Biography,Drama,History",Biography,"['Drama', 'History']",6,2015,mid,10000000,1822250,4824419,6646669,-3353331,66.46669
Rise of the Guardians,"Action,Adventure,Animation",Action,"['Adventure', 'Animation']",11,2012,high,145000000,103412758,203488144,306900902,161900902,211.6557944827586
Prometheus,"Adventure,Mystery,Sci-Fi",Adventure,"['Mystery', 'Sci-Fi']",6,2012,high,125000000,126477084,275971181,402448265,277448265,321.958612
Killer Elite,"Action,Crime,Thriller",Action,"['Crime', 'Thriller']",9,2011,high,70000000,25124986,40284060,65409046,-4590954,93.44149428571428
Winnie the Pooh,"Adventure,Animation,Comedy",Adventure,"['Animation', 'Comedy']",7,2011,mid,30000000,26692846,23452761,50145607,20145607,167.15202333333335
Monsters University,"Adventure,Animation,Comedy",Adventure,"['Animation', 'Comedy']",6,2013,high,200000000,268488329,475100000,743588329,543588329,371.79416449999997
The Help,Drama,Drama,[],8,2011,mid,25000000,169705587,43414417,213120004,188120004,852.480016
Gravity,"Drama,Sci-Fi,Thriller",Drama,"['Sci-Fi', 'Thriller']",10,2013,high,110000000,274092705,419605968,693698673,583698673,630.6351572727273
The Conjuring,"Horror,Mystery,Thriller",Horror,"['Mystery', 'Thriller']",7,2013,mid,20000000,137400141,180600000,318000141,298000141,1590.000705
The Next Three Days,"Action,Crime,Drama",Action,"['Crime', 'Drama']",11,2010,mid,30000000,21148651,46107265,67255916,37255916,224.1863866666667
Reign of Assassins,"Action,Adventure",Action,['Adventure'],11,2016,mid,14000000,0,11354230,11354230,-2645770,81.10164285714285
Dream House,"Drama,Mystery,Thriller",Drama,"['Mystery', 'Thriller']",9,2011,high,50000000,21302340,20339826,41642166,-8357834,83.284332
Letters to God,"Drama,Family",Drama,['Family'],4,2010,low,3000000,2848587,388865,3237452,237452,107.91506666666666
The Odd Life of Timothy Green,"Comedy,Drama,Family",Comedy,"['Drama', 'Family']",8,2012,mid,40000000,51853450,3395709,55249159,15249159,138.1228975
"Big Mommas: Like Father, Like Son","Action,Comedy,Crime",Action,"['Comedy', 'Crime']",2,2011,mid,32000000,37915414,44417036,82332450,50332450,257.28890624999997
Stake Land,"Drama,Horror,Sci-Fi",Drama,"['Horror', 'Sci-Fi']",4,2011,low,4000000,33245,646237,679482,-3320518,16.98705
Baywatch,"Action,Comedy,Crime",Action,"['Comedy', 'Crime']",5,2017,high,60000000,58060186,117803597,175863783,115863783,293.106305
Redemption Road,Drama,Drama,[],8,2011,low,2300000,29384,0,29384,-2270616,1.2775652173913044
MacGruber,"Action,Comedy,Romance",Action,"['Comedy', 'Romance']",5,2010,mid,10000000,8525600,104295,8629895,-1370105,86.29894999999999
Max Steel,"Action,Adventure,Family",Action,"['Adventure', 'Family']",10,2016,mid,10000000,3818664,744416,4563080,-5436920,45.6308
Aquaman,"Action,Adventure,Fantasy",Action,"['Adventure', 'Fantasy']",12,2018,high,160000000,335061807,811832833,1146894640,986894640,716.80915
Cedar Rapids,Comedy,Comedy,[],2,2011,mid,10000000,6861102,1001029,7862131,-2137869,78.62131
Bridesmaids,"Comedy,Romance",Comedy,['Romance'],5,2011,mid,32500000,169211718,120420305,289632023,257132023,891.1754553846154
Attack the Block,"Action,Comedy,Sci-Fi",Action,"['Comedy', 'Sci-Fi']",7,2011,mid,13000000,1024175,5435008,6459183,-6540817,49.68602307692308
Eddie: The Sleepwalking Cannibal,"Comedy,Horror",Comedy,['Horror'],4,2013,low,1400000,1632,0,1632,-1398368,0.11657142857142858
8: The Mormon Proposition,Documentary,Documentary,[],6,2010,low,2500000,100280,0,100280,-2399720,4.0112000000000005
The Greatest Showman,"Biography,Drama,Musical",Biography,"['Drama', 'Musical']",12,2017,high,84000000,174340174,212325376,386665550,302665550,460.31613095238095
Red Riding Hood,"Fantasy,Horror,Mystery",Fantasy,"['Horror', 'Mystery']",3,2011,mid,42000000,37662162,54016280,91678442,49678442,218.28200476190477
The Raven,"Crime,Mystery,Thriller",Crime,"['Mystery', 'Thriller']",4,2012,mid,26000000,16008272,14593529,30601801,4601801,117.69923461538461
5 Days of War,"Action,Drama,War",Action,"['Drama', 'War']",8,2011,mid,12000000,17479,70314,87793,-11912207,0.7316083333333333
Khumba,"Adventure,Animation,Family",Adventure,"['Animation', 'Family']",12,2013,mid,15000000,0,20898221,20898221,5898221,139.32147333333333
Zambezia,"Adventure,Animation,Comedy",Adventure,"['Animation', 'Comedy']",12,2012,mid,20000000,0,34454336,34454336,14454336,172.27168
The Change-Up,"Comedy,Fantasy",Comedy,['Fantasy'],8,2011,high,52000000,37243418,38753649,75997067,23997067,146.14820576923077
Central Intelligence,"Action,Comedy,Crime",Action,"['Comedy', 'Crime']",6,2016,high,50000000,127440871,89753934,217194805,167194805,434.38961
The Lego Movie,"Action,Adventure,Animation",Action,"['Adventure', 'Animation']",2,2014,high,60000000,257784718,199944670,457729388,397729388,762.8823133333333
The Iceman,"Biography,Crime,Drama",Biography,"['Crime', 'Drama']",5,2013,mid,10000000,1930282,1693327,3623609,-6376391,36.23609
The Paperboy,"Crime,Drama,Mystery",Crime,"['Drama', 'Mystery']",10,2012,mid,12500000,677200,3350463,4027663,-8472337,32.221304
Horrible Bosses,"Comedy,Crime",Comedy,['Crime'],7,2011,mid,35000000,117538559,94879042,212417601,177417601,606.9074314285715
Drive Angry,"Action,Fantasy,Thriller",Action,"['Fantasy', 'Thriller']",2,2011,high,50000000,10721033,30321550,41042583,-8957417,82.085166
Halloween,"Horror,Thriller",Horror,['Thriller'],10,2018,mid,10000000,159342015,95558652,254900667,244900667,2549.0066699999998
Fantastic Four,"Action,Adventure,Drama",Action,"['Adventure', 'Drama']",8,2015,high,120000000,56117548,111731639,167849187,47849187,139.8743225
Haywire,"Action,Drama,Thriller",Action,"['Drama', 'Thriller']",1,2012,mid,23000000,18942396,17432304,36374700,13374700,158.1508695652174
Le Havre,"Comedy,Drama",Comedy,['Drama'],10,2011,mid,5500000,611709,12868487,13480196,7980196,245.09447272727272
Griff the Invisible,"Comedy,Drama,Romance",Comedy,"['Drama', 'Romance']",8,2011,low,2900000,20778,5157,25935,-2874065,0.8943103448275862
Sherlock Holmes: A Game of Shadows,"Action,Adventure,Crime",Action,"['Adventure', 'Crime']",12,2011,high,125000000,186848418,348815025,535663443,410663443,428.53075440000003
Meek's Cutoff,"Drama,Western",Drama,['Western'],4,2011,low,2000000,977772,892156,1869928,-130072,93.49640000000001
Area 51,"Horror,Sci-Fi,Thriller",Horror,"['Sci-Fi', 'Thriller']",5,2015,mid,5000000,7556,0,7556,-4992444,0.15112
Contraband,"Action,Crime,Drama",Action,"['Crime', 'Drama']",1,2012,mid,25000000,66528000,31878855,98406855,73406855,393.62742000000003
The Vatican Tapes,"Horror,Thriller",Horror,['Thriller'],7,2015,mid,13000000,1784763,13144421,14929184,1929184,114.83987692307693
Vacation,"Adventure,Comedy",Adventure,['Comedy'],7,2015,mid,31000000,58884188,43422312,102306500,71306500,330.0209677419355
Grabbers,"Comedy,Horror,Sci-Fi",Comedy,"['Horror', 'Sci-Fi']",7,2013,mid,5300000,0,440821,440821,-4859179,8.317377358490566
Exodus: Gods and Kings,"Action,Adventure,Drama",Action,"['Adventure', 'Drama']",12,2014,high,140000000,65014513,203300000,268314513,128314513,191.65322357142858
Sea Rex 3D: Journey to a Prehistoric World,Documentary,Documentary,[],5,2010,mid,5000000,6096582,10418621,16515203,11515203,330.30406
Everything Must Go,"Comedy,Drama",Comedy,['Drama'],5,2011,mid,5000000,2712131,108879,2821010,-2178990,56.4202
Beginners,"Comedy,Drama,Romance",Comedy,"['Drama', 'Romance']",6,2011,low,3200000,5790894,8523513,14314407,11114407,447.32521875
Battle of the Year,"Drama,Music",Drama,['Music'],9,2013,mid,20000000,8888355,7835022,16723377,-3276623,83.616885
Beautiful Boy,Drama,Drama,[],10,2018,mid,25000000,7634767,5396657,13031424,-11968576,52.125696
Beyond the Black Rainbow,"Horror,Sci-Fi,Thriller",Horror,"['Sci-Fi', 'Thriller']",5,2012,low,1100000,56491,0,56491,-1043509,5.135545454545454
Captain Phillips,"Biography,Drama,Thriller",Biography,"['Drama', 'Thriller']",10,2013,high,55000000,107136417,113511767,220648184,165648184,401.1785163636364
Hope Springs,"Comedy,Drama,Romance",Comedy,"['Drama', 'Romance']",8,2012,mid,30000000,63536011,69549284,133085295,103085295,443.61765
The Son of No One,"Action,Crime,Drama",Action,"['Crime', 'Drama']",11,2011,mid,15000000,30680,1117898,1148578,-13851422,7.657186666666667
Paranormal Activity 2,Horror,Horror,[],10,2010,low,3000000,84752907,92759125,177512032,174512032,5917.067733333333
Leap Year,"Drama,Romance",Drama,['Romance'],1,2010,mid,19000000,25918920,6700000,32618920,13618920,171.67852631578947
The Mortal Instruments: City of Bones,"Action,Fantasy,Horror",Action,"['Fantasy', 'Horror']",8,2013,high,60000000,31165421,44800146,75965567,15965567,126.60927833333334
Blair Witch,"Horror,Mystery,Thriller",Horror,"['Mystery', 'Thriller']",9,2016,mid,10000000,20777061,18208516,38985577,28985577,389.85577
The Guard,"Comedy,Crime,Thriller",Comedy,"['Crime', 'Thriller']",7,2011,mid,6000000,5359774,15837680,21197454,15197454,353.2909
Snow Flower and the Secret Fan,"Drama,History",Drama,['History'],7,2011,mid,6000000,1348205,10000000,11348205,5348205,189.13675
127 Hours,"Adventure,Biography,Drama",Adventure,"['Biography', 'Drama']",11,2010,mid,18000000,18335230,41881941,60217171,42217171,334.5398388888889
The Grace Card,Drama,Drama,[],2,2011,low,200000,2430735,0,2430735,2230735,1215.3675
Premium Rush,"Action,Crime,Thriller",Action,"['Crime', 'Thriller']",8,2012,mid,35000000,20275446,11117755,31393201,-3606799,89.69486
Another Earth,"Drama,Romance,Sci-Fi",Drama,"['Romance', 'Sci-Fi']",7,2011,low,175000,1321194,781585,2102779,1927779,1201.588
Winnie Mandela,"Biography,Drama,History",Biography,"['Drama', 'History']",9,2013,mid,15000000,61847,0,61847,-14938153,0.4123133333333333
Country Strong,"Drama,Music",Drama,['Music'],12,2010,mid,15000000,20218921,383066,20601987,5601987,137.34658
Beautiful Creatures,"Drama,Fantasy,Romance",Drama,"['Fantasy', 'Romance']",2,2013,high,50000000,19452138,40830738,60282876,10282876,120.56575199999999
I Want Your Money,Documentary,Documentary,[],10,2010,low,400000,433588,0,433588,33588,108.397
The Devil Inside,Horror,Horror,[],1,2012,low,1000000,53262945,48496545,101759490,100759490,10175.949
Higher Ground,Drama,Drama,[],8,2011,low,1800000,841056,1637,842693,-957307,46.81627777777778
Amigo,"Drama,War",Drama,['War'],8,2011,low,1500000,184705,0,184705,-1315295,12.313666666666666
Overboard,"Comedy,Romance",Comedy,['Romance'],5,2018,mid,12000000,50316123,35053707,85369830,73369830,711.41525
Dolphin Tale,"Drama,Family",Drama,['Family'],9,2011,mid,37000000,72286779,23781945,96068724,59068724,259.64520000000005
Skyline,"Action,Sci-Fi,Thriller",Action,"['Sci-Fi', 'Thriller']",11,2010,mid,10000000,21416355,46848618,68264973,58264973,682.64973
For Greater Glory: The True Story of Cristiada,"Drama,History,War",Drama,"['History', 'War']",6,2012,mid,12000000,5669081,4357174,10026255,-1973745,83.552125
Man on a Ledge,"Action,Adventure,Crime",Action,"['Adventure', 'Crime']",1,2012,mid,42000000,18620000,31001440,49621440,7621440,118.14628571428571
The Girl with the Dragon Tattoo,"Crime,Drama,Mystery",Crime,"['Drama', 'Mystery']",12,2011,high,90000000,102515793,136858177,239373970,149373970,265.9710777777778
Tiny Furniture,"Comedy,Drama,Romance",Comedy,"['Drama', 'Romance']",11,2010,low,50000,391674,32475,424149,374149,848.298
A Dangerous Method,"Biography,Drama,Romance",Biography,"['Drama', 'Romance']",11,2011,mid,20000000,5702083,9105448,14807531,-5192469,74.037655
Mortal Engines,"Action,Adventure,Fantasy",Action,"['Adventure', 'Fantasy']",12,2018,high,100000000,15951040,69336377,85287417,-14712583,85.287417
The Skeleton Twins,"Comedy,Drama,Romance",Comedy,"['Drama', 'Romance']",9,2014,low,1000000,5284309,512883,5797192,4797192,579.7192
Texas Chainsaw 3D,"Horror,Thriller",Horror,['Thriller'],1,2013,mid,20000000,34341945,13324068,47666013,27666013,238.330065
The Dilemma,"Comedy,Drama",Comedy,['Drama'],1,2011,high,70000000,48475290,22071575,70546865,546865,100.78123571428573
House at the End of the Street,"Drama,Horror,Thriller",Drama,"['Horror', 'Thriller']",9,2012,mid,6900000,31611916,12492066,44103982,37203982,639.1881449275362
Larry Crowne,"Comedy,Drama,Romance",Comedy,"['Drama', 'Romance']",7,2011,mid,30000000,35608245,25840890,61449135,31449135,204.83044999999998
G.I. Joe: Retaliation,"Action,Adventure,Sci-Fi",Action,"['Adventure', 'Sci-Fi']",3,2013,high,140000000,122523060,253217645,375740705,235740705,268.38621785714287
The Last Godfather,"Comedy,Crime,Romance",Comedy,"['Crime', 'Romance']",4,2011,mid,13400000,164247,0,164247,-13235753,1.2257238805970148
What to Expect When You're Expecting,"Comedy,Drama,Romance",Comedy,"['Drama', 'Romance']",5,2012,mid,37500000,41152203,47320813,88473016,50973016,235.92804266666664
Burlesque,Drama,Drama,[],11,2010,high,55000000,39440655,51112020,90552675,35552675,164.64122727272726
Machine Gun Preacher,"Action,Biography,Crime",Action,"['Biography', 'Crime']",9,2011,mid,30000000,538690,3183298,3721988,-26278012,12.406626666666666
Maleficent,"Action,Adventure,Family",Action,"['Adventure', 'Family']",5,2014,high,180000000,241407328,517129407,758536735,578536735,421.40929722222216
Warm Bodies,"Comedy,Horror,Romance",Comedy,"['Horror', 'Romance']",2,2013,mid,30000000,66380662,48740946,115121608,85121608,383.73869333333334
"Jeff, Who Lives at Home","Comedy,Drama",Comedy,['Drama'],3,2012,mid,10000000,4269426,438701,4708127,-5291873,47.081269999999996
The Commuter,"Action,Mystery,Thriller",Action,"['Mystery', 'Thriller']",1,2018,mid,40000000,36343858,65641573,101985431,61985431,254.9635775
Insidious,"Horror,Mystery,Thriller",Horror,"['Mystery', 'Thriller']",4,2011,low,1500000,54009150,45861736,99870886,98370886,6658.059066666667
Act of Valor,"Action,Adventure,Drama",Action,"['Adventure', 'Drama']",2,2012,mid,12000000,70012847,12484188,82497035,70497035,687.4752916666667
Lockout,"Action,Sci-Fi,Thriller",Action,"['Sci-Fi', 'Thriller']",4,2012,mid,20000000,14326865,19616184,33943049,13943049,169.71524499999998
LOL,"Comedy,Drama,Romance",Comedy,"['Drama', 'Romance']",5,2012,mid,11000000,0,10431506,10431506,-568494,94.83187272727272
The Innkeepers,"Drama,Horror,Mystery",Drama,"['Horror', 'Mystery']",2,2012,low,750000,78396,933139,1011535,261535,134.87133333333335
Norm of the North,"Adventure,Animation,Comedy",Adventure,"['Animation', 'Comedy']",1,2016,mid,18000000,17062499,13473161,30535660,12535660,169.64255555555556
Fast Five,"Action,Crime,Thriller",Action,"['Crime', 'Thriller']",4,2011,high,125000000,210031325,420132129,630163454,505163454,504.1307632
Soul Surfer,"Biography,Drama,Family",Biography,"['Drama', 'Family']",4,2011,mid,18000000,43853424,3305228,47158652,29158652,261.9925111111111
This Means War,"Action,Comedy,Romance",Action,"['Comedy', 'Romance']",2,2012,high,65000000,54760791,102213766,156974557,91974557,241.49931846153848
The Big Short,"Biography,Comedy,Drama",Biography,"['Comedy', 'Drama']",12,2015,mid,28000000,70259870,62902882,133162752,105162752,475.58125714285717
The Woman in Black,"Drama,Fantasy,Horror",Drama,"['Fantasy', 'Horror']",2,2012,mid,15000000,54333290,74622608,128955898,113955898,859.7059866666667
Contagion,"Action,Drama,Thriller",Action,"['Drama', 'Thriller']",9,2011,high,60000000,75658097,61893497,137551594,77551594,229.25265666666667
One for the Money,"Action,Comedy,Crime",Action,"['Comedy', 'Crime']",1,2012,mid,42000000,26414527,9782694,36197221,-5802779,86.18385952380953
The Grey,"Action,Adventure,Drama",Action,"['Adventure', 'Drama']",1,2012,mid,25000000,51580136,29669040,81249176,56249176,324.996704
Albert Nobbs,"Drama,Romance",Drama,['Romance'],12,2011,mid,7500000,3014696,5524307,8539003,1039003,113.85337333333334
Only God Forgives,"Crime,Drama",Crime,['Drama'],7,2013,low,4800000,775849,3718711,4494560,-305440,93.63666666666667
Amour,"Drama,Romance",Drama,['Romance'],12,2012,mid,9700000,6738954,30048090,36787044,27087044,379.24787628865977
Prom,"Comedy,Drama,Family",Comedy,"['Drama', 'Family']",4,2011,mid,8000000,10130219,632964,10763183,2763183,134.5397875
American Reunion,Comedy,Comedy,[],4,2012,high,50000000,56758835,180040376,236799211,186799211,473.59842199999997
Midnight in Paris,"Comedy,Fantasy,Romance",Comedy,"['Fantasy', 'Romance']",5,2011,mid,30000000,56816662,105686112,162502774,132502774,541.6759133333334
A Good Day to Die Hard,"Action,Thriller",Action,['Thriller'],2,2013,high,92000000,67349198,236900000,304249198,212249198,330.70565
The Vow,"Drama,Romance",Drama,['Romance'],2,2012,mid,30000000,125014030,72604130,197618160,167618160,658.7271999999999
The Other Dream Team,"Documentary,Sport",Documentary,['Sport'],9,2012,low,500000,134109,180335,314444,-185556,62.8888
Zoolander 2,Comedy,Comedy,[],2,2016,high,50000000,28848693,26500000,55348693,5348693,110.69738600000001
Abraham Lincoln: Vampire Hunter,"Action,Fantasy,Horror",Action,"['Fantasy', 'Horror']",6,2012,high,67500000,37519139,99970591,137489730,69989730,203.68848888888888
Rubber,"Comedy,Fantasy,Horror",Comedy,"['Fantasy', 'Horror']",4,2011,low,500000,100370,580544,680914,180914,136.18280000000001
Savages,"Crime,Drama,Thriller",Crime,"['Drama', 'Thriller']",7,2012,mid,45000000,47323100,35190390,82513490,37513490,183.3633111111111
Margin Call,"Drama,Thriller",Drama,['Thriller'],10,2011,low,3400000,5353586,15079641,20433227,17033227,600.9772647058824
Alvin and the Chipmunks: Chipwrecked,"Adventure,Animation,Comedy",Adventure,"['Animation', 'Comedy']",12,2011,high,80000000,133107389,215981134,349088523,269088523,436.36065375
J. Edgar,"Biography,Crime,Drama",Biography,"['Crime', 'Drama']",11,2011,mid,35000000,37306030,47300000,84606030,49606030,241.7315142857143
Jupiter Ascending,"Action,Adventure,Sci-Fi",Action,"['Adventure', 'Sci-Fi']",2,2015,high,179000000,47482519,134500000,181982519,2982519,101.66621173184357
Dum Maaro Dum,"Action,Crime,Drama",Action,"['Crime', 'Drama']",4,2011,mid,5200000,564489,11068938,11633427,6433427,223.71975
The Last Witch Hunter,"Action,Adventure,Fantasy",Action,"['Adventure', 'Fantasy']",10,2015,high,80000000,27367660,103451252,130818912,50818912,163.52364
A Wrinkle in Time,"Adventure,Family,Fantasy",Adventure,"['Family', 'Fantasy']",3,2018,high,103000000,100478608,32923274,133401882,30401882,129.51639029126213
Bleed for This,"Biography,Drama,Sport",Biography,"['Drama', 'Sport']",11,2016,mid,16000000,5083906,1520020,6603926,-9396074,41.2745375
Free Birds,"Adventure,Animation,Comedy",Adventure,"['Animation', 'Comedy']",11,2013,high,55000000,55750480,54636592,110387072,55387072,200.70376727272725
Think Like a Man,"Comedy,Romance",Comedy,['Romance'],4,2012,mid,12000000,91547205,21826559,113373764,101373764,944.7813666666667
30 Minutes or Less,"Action,Comedy,Crime",Action,"['Comedy', 'Crime']",8,2011,mid,28000000,37053924,3912792,40966716,12966716,146.30970000000002
Final Destination 5,Horror,Horror,[],8,2011,mid,40000000,42587643,112423522,155011165,115011165,387.5279125
Oz the Great and Powerful,"Adventure,Family,Fantasy",Adventure,"['Family', 'Fantasy']",3,2013,high,200000000,234770996,255588055,490359051,290359051,245.17952549999998
ParaNorman,"Adventure,Animation,Comedy",Adventure,"['Animation', 'Comedy']",8,2012,high,60000000,56003051,52116611,108119662,48119662,180.19943666666666
Young Adult,"Comedy,Drama",Comedy,['Drama'],12,2011,mid,12000000,16311571,6438785,22750356,10750356,189.5863
Independence Day: Resurgence,"Action,Adventure,Sci-Fi",Action,"['Adventure', 'Sci-Fi']",6,2016,high,165000000,103144286,281025138,384169424,219169424,232.82995393939393
Blackthorn,"Action,Adventure,Western",Action,"['Adventure', 'Western']",10,2011,low,4500000,200558,1016749,1217307,-3282693,27.051266666666667
Chasing Mavericks,"Biography,Drama,Sport",Biography,"['Drama', 'Sport']",10,2012,mid,20000000,6002756,2298065,8300821,-11699179,41.504105
Courageous,Drama,Drama,[],9,2011,low,2000000,34522221,663663,35185884,33185884,1759.2942
Edge of Tomorrow,"Action,Sci-Fi",Action,['Sci-Fi'],6,2014,high,178000000,100206256,270335000,370541256,192541256,208.16924494382022
Friends with Benefits,"Comedy,Romance",Comedy,['Romance'],7,2011,mid,35000000,55802754,90793137,146595891,111595891,418.8454028571429
Shark Night 3D,"Horror,Thriller",Horror,['Thriller'],9,2011,mid,25000000,18877153,0,18877153,-6122847,75.508612
Johnny English Reborn,"Action,Adventure,Comedy",Action,"['Adventure', 'Comedy']",10,2011,mid,45000000,8406711,156233690,164640401,119640401,365.8675577777778
In Time,"Action,Crime,Drama",Action,"['Crime', 'Drama']",10,2011,mid,35000000,37553932,127550020,165103952,130103952,471.72557714285716
Our Idiot Brother,"Comedy,Drama",Comedy,['Drama'],8,2011,mid,5000000,24814830,1046419,25861249,20861249,517.2249800000001
Ted,"Comedy,Fantasy",Comedy,['Fantasy'],6,2012,high,50000000,218665740,337350887,556016627,506016627,1112.033254
Hobo with a Shotgun,"Action,Comedy,Horror",Action,"['Comedy', 'Horror']",5,2011,low,3000000,703372,131581,834953,-2165047,27.831766666666667
Jumping the Broom,"Comedy,Drama",Comedy,['Drama'],5,2011,mid,7000000,37295394,863207,38158601,31158601,545.1228714285714
A Few Best Men,"Comedy,Romance",Comedy,['Romance'],5,2015,mid,15000000,0,17224539,17224539,2224539,114.83026000000001
Skin Trade,"Action,Crime,Thriller",Action,"['Crime', 'Thriller']",5,2015,mid,9000000,1242,0,1242,-8998758,0.0138
The Art of Getting By,"Drama,Romance",Drama,['Romance'],6,2011,low,4000000,1430241,558794,1989035,-2010965,49.725875
Inside Job,"Crime,Documentary",Crime,['Documentary'],10,2010,low,2000000,4311834,3487423,7799257,5799257,389.96285
The Dictator,Comedy,Comedy,[],5,2012,high,65000000,59650222,120498675,180148897,115148897,277.1521492307692
How to Train Your Dragon 2,"Action,Adventure,Animation",Action,"['Adventure', 'Animation']",6,2014,high,145000000,177002924,437583346,614586270,469586270,423.85260000000005
Wrath of the Titans,"Action,Adventure,Fantasy",Action,"['Adventure', 'Fantasy']",3,2012,high,150000000,83670083,221600000,305270083,155270083,203.51338866666669
Million Dollar Arm,"Biography,Drama,Sport",Biography,"['Drama', 'Sport']",5,2014,mid,25000000,36447959,2769953,39217912,14217912,156.871648
Here Comes the Boom,"Action,Comedy,Sport",Action,"['Comedy', 'Sport']",10,2012,mid,42000000,45290318,27948940,73239258,31239258,174.3791857142857
The Dark Tower,"Action,Adventure,Fantasy",Action,"['Adventure', 'Fantasy']",8,2017,high,60000000,50701325,62760202,113461527,53461527,189.10254500000002
The Impossible,"Drama,History,Thriller",Drama,"['History', 'Thriller']",12,2012,mid,40000000,19019882,150570724,169590606,129590606,423.976515
Diary of a Wimpy Kid: Rodrick Rules,"Comedy,Family",Comedy,['Family'],3,2011,mid,18000000,52698535,20996659,73695194,55695194,409.4177444444444
Super 8,"Mystery,Sci-Fi,Thriller",Mystery,"['Sci-Fi', 'Thriller']",6,2011,high,50000000,127004179,130968566,257972745,207972745,515.9454900000001
Kick-Ass 2,"Action,Comedy,Crime",Action,"['Comedy', 'Crime']",8,2013,mid,28000000,28795985,34333924,63129909,35129909,225.4639607142857
My Week with Marilyn,"Biography,Drama",Biography,['Drama'],11,2011,mid,10000000,14597405,19643167,34240572,24240572,342.40572
The Age of Adaline,"Drama,Fantasy,Romance",Drama,"['Fantasy', 'Romance']",4,2015,mid,30000000,42629776,26354760,68984536,38984536,229.9484533333333
Colombiana,"Action,Drama,Thriller",Action,"['Drama', 'Thriller']",8,2011,mid,40000000,36665854,35629408,72295262,32295262,180.73815499999998
Freeheld,"Biography,Drama,Romance",Biography,"['Drama', 'Romance']",10,2015,mid,7000000,546201,1186027,1732228,-5267772,24.746114285714285
The Perks of Being a Wallflower,Drama,Drama,[],9,2012,mid,13000000,17742948,15326355,33069303,20069303,254.37925384615383
Grudge Match,"Comedy,Drama,Sport",Comedy,"['Drama', 'Sport']",12,2013,mid,40000000,29807260,40000000,69807260,29807260,174.51815
Polisse,"Crime,Drama",Crime,['Drama'],5,2012,mid,8900000,176988,22567144,22744132,13844132,255.55204494382022
Fun Size,"Adventure,Comedy",Adventure,['Comedy'],10,2012,mid,14000000,9409538,1757077,11166615,-2833385,79.76153571428571
Pacific Rim,"Action,Adventure,Sci-Fi",Action,"['Adventure', 'Sci-Fi']",7,2013,high,190000000,101802906,309200000,411002906,221002906,216.31731894736842
Middle Men,"Action,Comedy,Crime",Action,"['Comedy', 'Crime']",8,2010,mid,20000000,754301,0,754301,-19245699,3.771505
All Eyez on Me,"Biography,Drama,Music",Biography,"['Drama', 'Music']",6,2017,mid,45000000,44922302,9954553,54876855,9876855,121.94856666666666
Vampires Suck,Comedy,Comedy,[],8,2010,mid,20000000,36661504,44763484,81424988,61424988,407.12494000000004
Damsels in Distress,"Comedy,Drama,Romance",Comedy,"['Drama', 'Romance']",4,2012,low,3000000,1007535,316764,1324299,-1675701,44.1433
Deadfall,"Crime,Drama,Thriller",Crime,"['Drama', 'Thriller']",12,2012,mid,6000000,66351,1607284,1673635,-4326365,27.89391666666667
Mirror Mirror,"Adventure,Comedy,Drama",Adventure,"['Comedy', 'Drama']",3,2012,high,85000000,64935167,108678315,173613482,88613482,204.25115529411767
Ice Age: Continental Drift,"Adventure,Animation,Comedy",Adventure,"['Animation', 'Comedy']",7,2012,high,95000000,161321843,718443294,879765137,784765137,926.068565263158
The Sapphires,"Biography,Comedy,Drama",Biography,"['Comedy', 'Drama']",3,2013,mid,9000000,2450867,17944173,20395040,11395040,226.61155555555555
Entourage,Comedy,Comedy,[],6,2015,mid,30000000,32363404,14075134,46438538,16438538,154.79512666666665
Take Shelter,"Drama,Horror,Thriller",Drama,"['Horror', 'Thriller']",9,2011,low,4750000,1728953,3243063,4972016,222016,104.67402105263157
Ready Player One,"Action,Adventure,Sci-Fi",Action,"['Adventure', 'Sci-Fi']",3,2018,high,150000000,137690172,441599964,579290136,429290136,386.193424
Trolls,"Adventure,Animation,Comedy",Adventure,"['Animation', 'Comedy']",11,2016,high,125000000,153707064,190443070,344150134,219150134,275.3201072
Stoker,"Drama,Thriller",Drama,['Thriller'],3,2013,mid,12000000,1703125,10331788,12034913,34913,100.29094166666668
Circumstance,Drama,Drama,[],8,2011,low,900000,454121,504857,958978,58978,106.55311111111112
Despicable Me 2,"Adventure,Animation,Comedy",Adventure,"['Animation', 'Comedy']",7,2013,high,76000000,368065385,607151450,975216835,899216835,1283.1800460526315
Before I Fall,"Drama,Fantasy,Mystery",Drama,"['Fantasy', 'Mystery']",3,2017,mid,5000000,12241072,6704610,18945682,13945682,378.91364
The Guilt Trip,"Comedy,Drama",Comedy,['Drama'],12,2012,mid,40000000,37134215,4160459,41294674,1294674,103.23668500000001
The Virginity Hit,Comedy,Comedy,[],9,2010,low,2000000,636706,0,636706,-1363294,31.8353
"Alexander and the Terrible, Horrible, No Good, Very Bad Day","Comedy,Family",Comedy,['Family'],10,2014,mid,28000000,66954149,34425138,101379287,73379287,362.06888214285715
Peeples,"Comedy,Romance",Comedy,['Romance'],5,2013,mid,11000000,9177065,130101,9307166,-1692834,84.6106
Sausage Party,"Adventure,Animation,Comedy",Adventure,"['Animation', 'Comedy']",8,2016,mid,19000000,97670358,43673897,141344255,122344255,743.9171315789474
Casa de mi Padre,"Comedy,Western",Comedy,['Western'],3,2012,mid,6000000,5909483,2537469,8446952,2446952,140.78253333333333
Justin Bieber: Never Say Never,"Documentary,Music",Documentary,['Music'],2,2011,mid,13000000,73013910,26020215,99034125,86034125,761.8009615384615
Grave Encounters,Horror,Horror,[],9,2011,low,2000000,0,2151887,2151887,151887,107.59434999999999
Chronicle,"Drama,Sci-Fi,Thriller",Drama,"['Sci-Fi', 'Thriller']",2,2012,mid,12000000,64575175,59106615,123681790,111681790,1030.6815833333333
Snowpiercer,"Action,Drama,Sci-Fi",Action,"['Drama', 'Sci-Fi']",6,2014,mid,40000000,4563029,83506851,88069880,48069880,220.1747
The Last Days on Mars,"Adventure,Horror,Sci-Fi",Adventure,"['Horror', 'Sci-Fi']",12,2013,mid,10600000,24084,237280,261364,-10338636,2.465698113207547
Joyful Noise,"Comedy,Drama,Music",Comedy,"['Drama', 'Music']",1,2012,mid,27500000,30932113,225801,31157914,3657914,113.30150545454545
Office Christmas Party,Comedy,Comedy,[],12,2016,mid,45000000,54767494,36555805,91323299,46323299,202.94066444444442
Alex Cross,"Action,Crime,Mystery",Action,"['Crime', 'Mystery']",10,2012,mid,35000000,25888412,9538347,35426759,426759,101.21931142857143
Triple 9,"Crime,Thriller",Crime,['Thriller'],2,2016,mid,20000000,12639297,13304495,25943792,5943792,129.71896
The Spectacular Now,"Comedy,Drama,Romance",Comedy,"['Drama', 'Romance']",8,2013,low,2500000,6852971,63980,6916951,4416951,276.67804
Raymond Did It,Horror,Horror,[],2,2011,low,40000,3632,0,3632,-36368,9.08
Another Happy Day,"Comedy,Drama",Comedy,['Drama'],11,2011,low,4000000,9120,969407,978527,-3021473,24.463175
Vamps,"Comedy,Horror,Thriller",Comedy,"['Horror', 'Thriller']",11,2012,mid,16000000,3361,91451,94812,-15905188,0.592575
October Baby,Drama,Drama,[],3,2012,low,1000000,5355847,36145,5391992,4391992,539.1992
We're the Millers,"Comedy,Crime",Comedy,['Crime'],8,2013,mid,37000000,150394119,117422157,267816276,230816276,723.827772972973
L!fe Happens,Comedy,Comedy,[],4,2012,low,930000,30905,0,30905,-899095,3.323118279569892
Before I Go to Sleep,"Drama,Horror,Mystery",Drama,"['Horror', 'Mystery']",10,2014,mid,22000000,3242457,16321122,19563579,-2436421,88.9253590909091
Killer Joe,"Crime,Drama,Thriller",Crime,"['Drama', 'Thriller']",7,2012,mid,10000000,1291645,3367465,4659110,-5340890,46.591100000000004
The Way Way Back,"Comedy,Drama",Comedy,['Drama'],7,2013,mid,5000000,21502690,5351120,26853810,21853810,537.0762
Scouts Guide to the Zombie Apocalypse,"Action,Comedy,Horror",Action,"['Comedy', 'Horror']",10,2015,mid,15000000,3703046,11851809,15554855,554855,103.69903333333332
Bohemian Rhapsody,"Biography,Drama,Music",Biography,"['Drama', 'Music']",11,2018,high,55000000,216303339,678682003,894985342,839985342,1627.2460763636363
Darling Companion,"Comedy,Drama,Romance",Comedy,"['Drama', 'Romance']",4,2012,mid,12000000,793352,406994,1200346,-10799654,10.002883333333333
Ender's Game,"Action,Adventure,Fantasy",Action,"['Adventure', 'Fantasy']",11,2013,high,110000000,61737191,66246092,127983283,17983283,116.34843909090908
The Lords of Salem,"Horror,Thriller",Horror,['Thriller'],4,2013,low,1500000,1165881,375250,1541131,41131,102.74206666666667
50/50,Documentary,Documentary,[],9,2011,mid,8000000,35016118,6318617,41334735,33334735,516.6841875
Snow White and the Huntsman,"Action,Adventure,Drama",Action,"['Adventure', 'Drama']",6,2012,high,170000000,155136755,245884991,401021746,231021746,235.89514470588236
Secret in Their Eyes,"Crime,Drama,Mystery",Crime,"['Drama', 'Mystery']",11,2015,mid,20000000,20180155,12427864,32608019,12608019,163.040095
Jersey Boys,"Biography,Drama,Music",Biography,"['Drama', 'Music']",6,2014,mid,40000000,47047013,18235719,65282732,25282732,163.20683
Sabotage,"Action,Crime,Drama",Action,"['Crime', 'Drama']",3,2014,mid,35000000,10508518,7867925,18376443,-16623557,52.50412285714285
Your Sister's Sister,"Comedy,Drama",Comedy,['Drama'],6,2012,low,120000,1597486,1493107,3090593,2970593,2575.494166666667
I Don't Know How She Does It,"Comedy,Romance",Comedy,['Romance'],9,2011,mid,24000000,9659074,14815389,24474463,474463,101.97692916666668
Moonrise Kingdom,"Adventure,Comedy,Drama",Adventure,"['Comedy', 'Drama']",5,2012,mid,16000000,45512466,23335980,68848446,52848446,430.30278749999997
Red Lights,"Drama,Fantasy,Horror",Drama,"['Fantasy', 'Horror']",7,2012,mid,17700000,49521,14469363,14518884,-3181116,82.02759322033899
Sound of My Voice,"Drama,Mystery,Sci-Fi",Drama,"['Mystery', 'Sci-Fi']",4,2012,low,135000,408015,21433,429448,294448,318.1096296296296
The Collection,"Action,Horror,Thriller",Action,"['Horror', 'Thriller']",11,2012,mid,10000000,6810754,2079340,8890094,-1109906,88.90093999999999
The Ghastly Love of Johnny X,"Comedy,Fantasy,Musical",Comedy,"['Fantasy', 'Musical']",10,2012,low,2000000,2436,0,2436,-1997564,0.12179999999999999
Twixt,"Comedy,Fantasy,Horror",Comedy,"['Fantasy', 'Horror']",7,2013,mid,7000000,0,1268346,1268346,-5731654,18.11922857142857
Blue Like Jazz,"Comedy,Drama",Comedy,['Drama'],4,2012,low,1200000,595018,0,595018,-604982,49.584833333333336
People Like Us,Drama,Drama,[],6,2012,mid,16000000,12431792,185680,12617472,-3382528,78.8592
The To Do List,"Comedy,Romance",Comedy,['Romance'],7,2013,low,1500000,3491669,637159,4128828,2628828,275.2552
The Snowman,"Crime,Drama,Mystery",Crime,"['Drama', 'Mystery']",10,2017,mid,35000000,6670765,36555381,43226146,8226146,123.50327428571428
Arbitrage,"Drama,Thriller",Drama,['Thriller'],9,2012,mid,12000000,7919574,27911139,35830713,23830713,298.589275
Killing Them Softly,"Crime,Thriller",Crime,['Thriller'],11,2012,mid,15000000,14945541,24292902,39238443,24238443,261.58961999999997
The Expendables 2,"Action,Adventure,Thriller",Action,"['Adventure', 'Thriller']",8,2012,high,100000000,85028192,226951064,311979256,211979256,311.979256
Silent House,"Drama,Horror,Mystery",Drama,"['Horror', 'Mystery']",3,2012,low,2000000,12739737,3871023,16610760,14610760,830.538
The Giant Mechanical Man,"Comedy,Drama,Romance",Comedy,"['Drama', 'Romance']",4,2012,low,900000,7396,0,7396,-892604,0.8217777777777777
Apollo 18,"Horror,Mystery,Sci-Fi",Horror,"['Mystery', 'Sci-Fi']",9,2011,mid,5000000,17686929,8830890,26517819,21517819,530.3563800000001
Danny Collins,"Biography,Comedy,Drama",Biography,"['Comedy', 'Drama']",3,2015,mid,10000000,5637066,2828779,8465845,-1534155,84.65845
Wreck-It Ralph,"Adventure,Animation,Comedy",Adventure,"['Animation', 'Comedy']",11,2012,high,165000000,189412677,307098844,496511521,331511521,300.9160733333333
Trade of Innocents,"Drama,Thriller",Drama,['Thriller'],10,2012,mid,5800000,15091,0,15091,-5784909,0.26018965517241377
Outside Bet,Comedy,Comedy,[],2,2015,mid,7500000,0,13524,13524,-7486476,0.18032
A Star is Born,"Documentary,Music",Documentary,['Music'],10,2018,mid,36000000,215288866,218160705,433449571,397449571,1204.026586111111
50 to 1,Drama,Drama,[],3,2014,mid,10000000,1069454,0,1069454,-8930546,10.69454
Paranormal Activity 3,"Horror,Mystery,Thriller",Horror,"['Mystery', 'Thriller']",10,2011,mid,5000000,104028807,103011037,207039844,202039844,4140.79688
Anna Karenina,"Drama,Romance",Drama,['Romance'],11,2012,mid,49000000,12816367,58188260,71004627,22004627,144.90740204081632
Hands of Stone,"Action,Biography,Drama",Action,"['Biography', 'Drama']",8,2016,mid,20000000,4712792,319183,5031975,-14968025,25.159875
Elysium,Drama,Drama,[],8,2013,high,120000000,93050117,193141974,286192091,166192091,238.49340916666665
Madea's Big Happy Family,"Comedy,Drama",Comedy,['Drama'],4,2011,mid,25000000,53345287,815531,54160818,29160818,216.643272
Kill List,"Crime,Drama,Horror",Crime,"['Drama', 'Horror']",2,2012,low,800000,29063,433143,462206,-337794,57.77575
Pirates of the Caribbean: Dead Men Tell No Tales,"Action,Adventure,Fantasy",Action,"['Adventure', 'Fantasy']",5,2017,high,230000000,172558876,615682261,788241137,558241137,342.71353782608696
The Maze Runner,"Action,Mystery,Sci-Fi",Action,"['Mystery', 'Sci-Fi']",9,2014,mid,34000000,102427862,245891999,348319861,314319861,1024.4701794117648
Zero Dark Thirty,"Drama,Thriller",Drama,['Thriller'],12,2012,high,52500000,95720716,38891719,134612435,82112435,256.4046380952381
Inherent Vice,"Comedy,Crime,Drama",Comedy,"['Crime', 'Drama']",12,2014,mid,20000000,8110975,6661371,14772346,-5227654,73.86173000000001
While We're Young,"Comedy,Drama,Mystery",Comedy,"['Drama', 'Mystery']",3,2015,mid,10000000,7582065,9921763,17503828,7503828,175.03828
Cirque du Soleil: Worlds Away,Fantasy,Fantasy,[],12,2012,mid,25000000,12512862,15500000,28012862,3012862,112.051448
Rudderless,"Comedy,Drama,Music",Comedy,"['Drama', 'Music']",10,2014,mid,5000000,56001,511218,567219,-4432781,11.34438
Southpaw,"Drama,Sport",Drama,['Sport'],7,2015,mid,30000000,52421953,41734503,94156456,64156456,313.8548533333333
Her,"Drama,Romance,Sci-Fi",Drama,"['Romance', 'Sci-Fi']",1,2014,mid,23000000,25568251,22595564,48163815,25163815,209.40789130434783
American Hustle,"Crime,Drama",Crime,['Drama'],12,2013,mid,40000000,150117807,107760487,257878294,217878294,644.695735
That Awkward Moment,"Comedy,Romance",Comedy,['Romance'],1,2014,mid,8000000,26068955,27000000,53068955,45068955,663.3619375000001
Step Up Revolution,"Drama,Music,Romance",Drama,"['Music', 'Romance']",7,2012,mid,33000000,35074677,130477613,165552290,132552290,501.67360606060606
Gotti,"Biography,Crime,Drama",Biography,"['Crime', 'Drama']",6,2018,mid,10000000,4286367,1802733,6089100,-3910900,60.891
Unbroken,"Biography,Drama,Sport",Biography,"['Drama', 'Sport']",12,2014,high,65000000,115637895,47889929,163527824,98527824,251.5812676923077
Little Boy,"Drama,History,War",Drama,"['History', 'War']",4,2015,mid,20000000,6485961,11283338,17769299,-2230701,88.846495
Admission,"Comedy,Drama,Romance",Comedy,"['Drama', 'Romance']",3,2013,mid,13000000,18007317,726349,18733666,5733666,144.10512307692306
After Earth,"Action,Adventure,Drama",Action,"['Adventure', 'Drama']",5,2013,high,130000000,60522097,190977568,251499665,121499665,193.46128076923077
The Place Beyond the Pines,"Crime,Drama,Thriller",Crime,"['Drama', 'Thriller']",3,2013,mid,15000000,21403519,25607930,47011449,32011449,313.40966
Freaks of Nature,"Comedy,Horror,Sci-Fi",Comedy,"['Horror', 'Sci-Fi']",10,2015,mid,33000000,70958,0,70958,-32929042,0.21502424242424242
Nebraska,"Adventure,Comedy,Drama",Adventure,"['Comedy', 'Drama']",11,2013,mid,12000000,17654912,7106448,24761360,12761360,206.34466666666665
The Nut Job,"Adventure,Animation,Comedy",Adventure,"['Animation', 'Comedy']",1,2014,mid,30000000,64251538,58278428,122529966,92529966,408.43322000000006
RED 2,"Action,Comedy,Crime",Action,"['Comedy', 'Crime']",7,2013,high,84000000,53262560,88244795,141507355,57507355,168.4611369047619
Sparrows Dance,"Comedy,Drama,Romance",Comedy,"['Drama', 'Romance']",8,2013,low,175000,2602,0,2602,-172398,1.4868571428571429
Chappie,"Action,Crime,Drama",Action,"['Crime', 'Drama']",3,2015,mid,49000000,31569268,73432788,105002056,56002056,214.28991020408162
Black Panther,"Action,Adventure,Sci-Fi",Action,"['Adventure', 'Sci-Fi']",2,2018,high,200000000,700059566,648198658,1348258224,1148258224,674.129112
About Last Night,"Comedy,Romance",Comedy,['Romance'],2,2014,mid,13000000,48637684,1808176,50445860,37445860,388.0450769230769
Space Pirate Captain Harlock,"Animation,Sci-Fi",Animation,['Sci-Fi'],12,2013,mid,30000000,0,310985,310985,-29689015,1.0366166666666665
Dhoom 3,"Action,Thriller",Action,['Thriller'],12,2013,mid,24000000,8031955,3691665,11723620,-12276380,48.848416666666665
Queen of the Desert,"Adventure,Biography,Drama",Adventure,"['Biography', 'Drama']",4,2017,mid,36000000,0,1578543,1578543,-34421457,4.3848416666666665
The Fifth Estate,"Biography,Drama,Thriller",Biography,"['Drama', 'Thriller']",10,2013,mid,26000000,3254172,2900000,6154172,-19845828,23.669892307692308
The Face of Love,"Drama,Mystery,Romance",Drama,"['Mystery', 'Romance']",3,2014,low,4000000,385069,773808,1158877,-2841123,28.971925
Divergent,"Action,Adventure,Mystery",Action,"['Adventure', 'Mystery']",3,2014,high,85000000,150947895,125067070,276014965,191014965,324.7234882352941
The Words,"Drama,Mystery,Romance",Drama,"['Mystery', 'Romance']",9,2012,mid,6000000,11494838,4874870,16369708,10369708,272.82846666666666
Captain America: The Winter Soldier,"Action,Adventure,Sci-Fi",Action,"['Adventure', 'Sci-Fi']",4,2014,high,170000000,259746958,454654931,714401889,544401889,420.2364052941176
Inescapable,"Action,Drama,Mystery",Action,"['Drama', 'Mystery']",2,2013,low,4000000,4327,0,4327,-3995673,0.10817500000000001
Django Unchained,"Drama,Western",Drama,['Western'],12,2012,high,100000000,162805434,287142889,449948323,349948323,449.948323
You're Next,"Action,Comedy,Horror",Action,"['Comedy', 'Horror']",8,2013,low,1000000,18494006,8393171,26887177,25887177,2688.7177
Percy Jackson: Sea of Monsters,"Adventure,Family,Fantasy",Adventure,"['Family', 'Fantasy']",8,2013,high,90000000,68559554,132300000,200859554,110859554,223.17728222222223
End of Watch,"Action,Crime,Drama",Action,"['Crime', 'Drama']",9,2012,mid,15000000,41003371,16583235,57586606,42586606,383.91070666666667
Resident Evil: Retribution,"Action,Horror,Sci-Fi",Action,"['Horror', 'Sci-Fi']",9,2012,high,65000000,42345531,198302098,240647629,175647629,370.2271215384616
Tim and Eric's Billion Dollar Movie,Comedy,Comedy,[],3,2012,low,3000000,201436,22216,223652,-2776348,7.455066666666667
Blade Runner 2049,"Drama,Mystery,Sci-Fi",Drama,"['Mystery', 'Sci-Fi']",10,2017,high,185000000,92054159,167303249,259357408,74357408,140.1931935135135
To Rome with Love,"Comedy,Music,Romance",Comedy,"['Music', 'Romance']",6,2012,mid,21500000,16684352,57641663,74326015,52826015,345.70239534883723
Dirty Grandpa,Comedy,Comedy,[],1,2016,mid,11500000,35593113,69485336,105078449,93578449,913.7256434782608
Turbo,"Adventure,Animation,Comedy",Adventure,"['Animation', 'Comedy']",7,2013,high,135000000,83028130,203868448,286896578,151896578,212.5159837037037
Deepwater Horizon,"Action,Drama,History",Action,"['Drama', 'History']",9,2016,high,156000000,61433527,61170297,122603824,-33396176,78.59219487179487
Safety Not Guaranteed,"Comedy,Drama,Romance",Comedy,"['Drama', 'Romance']",6,2012,low,750000,4010957,411361,4422318,3672318,589.6424
Detention of the Dead,"Action,Adventure,Comedy",Action,"['Adventure', 'Comedy']",6,2013,low,500000,1778,0,1778,-498222,0.3556
The Sessions,"Biography,Comedy,Drama",Biography,"['Comedy', 'Drama']",10,2012,low,1000000,6002451,5492753,11495204,10495204,1149.5203999999999
Filly Brown,"Drama,Music",Drama,['Music'],4,2013,low,1250000,2850357,90054,2940411,1690411,235.23288
The East,"Adventure,Drama,Thriller",Adventure,"['Drama', 'Thriller']",5,2013,mid,6500000,2274649,753307,3027956,-3472044,46.58393846153846
The Amazing Spider-Man 2,"Action,Adventure,Sci-Fi",Action,"['Adventure', 'Sci-Fi']",5,2014,high,200000000,202853933,506142403,708996336,508996336,354.49816799999996
Supporting Characters,Comedy,Comedy,[],1,2013,low,60000,4917,0,4917,-55083,8.195
Sparkle,"Drama,Music",Drama,['Music'],8,2012,mid,10000000,24397469,262854,24660323,14660323,246.60323000000002
X-Men: Days of Future Past,"Action,Adventure,Sci-Fi",Action,"['Adventure', 'Sci-Fi']",5,2014,high,200000000,233921534,513941241,747862775,547862775,373.9313875
The Edge of Seventeen,"Comedy,Drama",Comedy,['Drama'],11,2016,mid,9000000,14431633,4664370,19096003,10096003,212.17781111111108
Newlyweds,"Comedy,Drama",Comedy,['Drama'],1,2012,low,9000,4584,0,4584,-4416,50.93333333333333
Parker,"Action,Crime,Thriller",Action,"['Crime', 'Thriller']",1,2013,mid,35000000,17616641,30926747,48543388,13543388,138.6953942857143
Hardflip,"Action,Drama",Action,['Drama'],6,2012,low,1000000,96734,0,96734,-903266,9.6734
Penguins of Madagascar,"Adventure,Animation,Comedy",Adventure,"['Animation', 'Comedy']",11,2014,high,132000000,83350911,283591620,366942531,234942531,277.98676590909093
Magic Mike,"Comedy,Drama",Comedy,['Drama'],6,2012,mid,7000000,113721571,56828182,170549753,163549753,2436.4250428571427
Bachelorette,"Comedy,Romance",Comedy,['Romance'],9,2012,low,3000000,446770,12130631,12577401,9577401,419.2467
Pompeii,"Action,Adventure,Drama",Action,"['Adventure', 'Drama']",2,2014,high,80000000,23169033,85300000,108469033,28469033,135.58629125
Glee: The 3D Concert Movie,"Documentary,Music",Documentary,['Music'],8,2011,mid,9000000,11862398,5600000,17462398,8462398,194.02664444444443
Open Road,"Action,Drama,Thriller",Action,"['Drama', 'Thriller']",5,2013,low,3000000,0,47469,47469,-2952531,1.5823
The Big Wedding,"Comedy,Drama,Romance",Comedy,"['Drama', 'Romance']",4,2013,mid,32500000,21819348,26606623,48425971,15925971,149.0029876923077
Seven Psychopaths,"Comedy,Crime",Comedy,['Crime'],10,2012,mid,13500000,15024049,18011687,33035736,19535736,244.70915555555558
Venom,Thriller,Thriller,[],10,2018,high,116000000,213511408,640117197,853628605,737628605,735.8867284482758
The Brass Teapot,"Comedy,Fantasy,Thriller",Comedy,"['Fantasy', 'Thriller']",4,2013,low,900000,6997,406736,413733,-486267,45.970333333333336
Carrie,"Drama,Horror",Drama,['Horror'],10,2013,mid,30000000,35266619,47142901,82409520,52409520,274.6984
UglyDolls,"Adventure,Animation,Comedy",Adventure,"['Animation', 'Comedy']",5,2019,mid,45000000,19894664,4750000,24644664,-20355336,54.76592
Drunk Wedding,Comedy,Comedy,[],5,2015,low,600000,3301,0,3301,-596699,0.5501666666666667
The Hunger Games: Catching Fire,"Action,Adventure,Sci-Fi",Action,"['Adventure', 'Sci-Fi']",11,2013,high,130000000,424668047,440200000,864868047,734868047,665.2831130769231
The Hunger Games: Mockingjay - Part 1,"Action,Adventure,Sci-Fi",Action,"['Adventure', 'Sci-Fi']",11,2014,high,125000000,337135885,429439246,766575131,641575131,613.2601048
The Hunger Games: Mockingjay - Part 2,"Action,Adventure,Sci-Fi",Action,"['Adventure', 'Sci-Fi']",11,2015,high,160000000,281723902,367262885,648986787,488986787,405.616741875
Sex Tape,"Comedy,Romance",Comedy,['Romance'],7,2014,mid,40000000,38543473,87526036,126069509,86069509,315.1737725
American Assassin,"Action,Thriller",Action,['Thriller'],9,2017,high,63000000,36249674,32060466,68310140,5310140,108.42879365079365
Labor Day,"Drama,Romance",Drama,['Romance'],1,2014,mid,18000000,13371528,818282,14189810,-3810190,78.83227777777778
The Comedian,Comedy,Comedy,[],2,2017,mid,15000000,1658706,0,1658706,-13341294,11.05804
Compliance,"Biography,Crime,Drama",Biography,"['Crime', 'Drama']",8,2012,low,270000,319285,511415,830700,560700,307.6666666666667
A Most Wanted Man,"Crime,Drama,Thriller",Crime,"['Drama', 'Thriller']",7,2014,mid,15000000,17237855,18831035,36068890,21068890,240.45926666666668
King Arthur: Legend of the Sword,"Action,Adventure,Drama",Action,"['Adventure', 'Drama']",5,2017,high,175000000,39175066,100455270,139630336,-35369664,79.78876342857143
The Best of Me,"Drama,Romance",Drama,['Romance'],10,2014,mid,26000000,26766213,14293205,41059418,15059418,157.92083846153847
The Neon Demon,"Horror,Thriller",Horror,['Thriller'],6,2016,mid,7500000,1333124,2226679,3559803,-3940197,47.464040000000004
Victor Frankenstein,"Drama,Horror,Sci-Fi",Drama,"['Horror', 'Sci-Fi']",11,2015,mid,40000000,5775076,25349291,31124367,-8875633,77.8109175
Sholem Aleichem: Laughing in the Darkness,Documentary,Documentary,[],7,2011,low,500000,1131261,0,1131261,631261,226.25220000000002
The Good Dinosaur,"Adventure,Animation,Comedy",Adventure,"['Animation', 'Comedy']",11,2015,high,187500000,123087120,210683917,333771037,146271037,178.01121973333335
Pain & Gain,"Action,Comedy,Crime",Action,"['Comedy', 'Crime']",4,2013,mid,26000000,49875291,31400000,81275291,55275291,312.5972730769231
Begin Again,"Comedy,Drama,Music",Comedy,"['Drama', 'Music']",6,2014,mid,8000000,16170632,52668104,68838736,60838736,860.4842
The Young and Prodigious T.S. Spivet,"Action,Adventure,Comedy",Action,"['Adventure', 'Comedy']",7,2015,mid,33000000,176847,180840,357687,-32642313,1.0838999999999999
Thor: The Dark World,"Action,Adventure,Fantasy",Action,"['Adventure', 'Fantasy']",11,2013,high,150000000,206362140,438240376,644602516,494602516,429.73501066666665
Geostorm,"Action,Sci-Fi,Thriller",Action,"['Sci-Fi', 'Thriller']",10,2017,high,100000000,33700160,187095849,220796009,120796009,220.79600899999997
Pitch Perfect,"Comedy,Music,Romance",Comedy,"['Music', 'Romance']",9,2012,mid,17000000,65001093,51043254,116044347,99044347,682.613805882353
The Harvest/La Cosecha,Documentary,Documentary,[],7,2011,low,560000,3709,0,3709,-556291,0.6623214285714286
The Angry Birds Movie,"Action,Animation,Comedy",Action,"['Animation', 'Comedy']",5,2016,high,73000000,107509366,244818521,352327887,279327887,482.6409410958904
Cloudy with a Chance of Meatballs 2,"Adventure,Animation,Comedy",Adventure,"['Animation', 'Comedy']",9,2013,high,78000000,119793567,154599082,274392649,196392649,351.7854474358974
The Upside,"Comedy,Drama",Comedy,['Drama'],1,2019,mid,37500000,108235497,10789039,119024536,81524536,317.39876266666664
Robot & Frank,"Comedy,Crime,Drama",Comedy,"['Crime', 'Drama']",8,2012,low,2500000,3317468,1616888,4934356,2434356,197.37424
Chernobyl Diaries,"Horror,Mystery,Thriller",Horror,"['Mystery', 'Thriller']",5,2012,low,1000000,18119640,24292081,42411721,41411721,4241.1721
Kevin Hart: Laugh at My Pain,"Comedy,Documentary",Comedy,['Documentary'],9,2011,low,750000,7706436,6000,7712436,6962436,1028.3248
Hell Fest,Horror,Horror,[],9,2018,mid,5500000,11107431,7011800,18119231,12619231,329.4405636363636
Machete Kills,"Action,Crime,Sci-Fi",Action,"['Crime', 'Sci-Fi']",10,2013,mid,20000000,8008161,10264848,18273009,-1726991,91.365045
War Dogs,"Comedy,Crime,Drama",Comedy,"['Crime', 'Drama']",8,2016,high,50000000,43034523,43199980,86234503,36234503,172.46900599999998
The Frozen Ground,"Crime,Drama,Mystery",Crime,"['Drama', 'Mystery']",8,2013,mid,19200000,0,5617460,5617460,-13582540,29.257604166666667
The 33,"Biography,Drama,History",Biography,"['Drama', 'History']",11,2015,mid,25000000,12227722,16172993,28400715,3400715,113.60285999999999
No Good Deed,"Action,Crime,Drama",Action,"['Crime', 'Drama']",9,2014,mid,13200000,52543632,1779578,54323210,41123210,411.5394696969697
Banshee Chapter,"Horror,Sci-Fi,Thriller",Horror,"['Sci-Fi', 'Thriller']",1,2014,low,950000,0,78122,78122,-871878,8.223368421052632
Guardians of the Galaxy,"Action,Adventure,Comedy",Action,"['Adventure', 'Comedy']",8,2014,high,170000000,333172112,437695404,770867516,600867516,453.45148
The Smurfs 2,"Adventure,Animation,Comedy",Adventure,"['Animation', 'Comedy']",7,2013,high,110000000,71017784,277529739,348547523,238547523,316.86138454545454
Closer to the Moon,"Comedy,Crime,Drama",Comedy,"['Crime', 'Drama']",4,2014,low,1500000,0,5396,5396,-1494604,0.35973333333333335
The Kick,"Action,Sport",Action,['Sport'],12,2011,low,3500000,0,40622,40622,-3459378,1.1606285714285716
Diary of a Wimpy Kid: Dog Days,"Comedy,Family",Comedy,['Family'],8,2012,mid,22000000,49008662,28221033,77229695,55229695,351.0440681818182
Identity Thief,"Adventure,Comedy,Crime",Adventure,"['Comedy', 'Crime']",2,2013,mid,35000000,134506920,40854658,175361578,140361578,501.03308000000004
Non-Stop,"Action,Mystery,Thriller",Action,"['Mystery', 'Thriller']",2,2014,high,50000000,91742160,130640895,222383055,172383055,444.76611
12 Years a Slave,"Biography,Drama,History",Biography,"['Drama', 'History']",10,2013,mid,20000000,56671993,124353350,181025343,161025343,905.1267149999999
The Finest Hours,"Action,Drama,History",Action,"['Drama', 'History']",1,2016,high,70000000,27569558,21683203,49252761,-20747239,70.36108714285714
A Better Life,Drama,Drama,[],6,2011,mid,10000000,1759252,124999,1884251,-8115749,18.84251
The Reluctant Fundamentalist,"Drama,Thriller",Drama,['Thriller'],4,2013,mid,15000000,528731,0,528731,-14471269,3.524873333333333
USS Indianapolis: Men of Courage,"Action,Drama,History",Action,"['Drama', 'History']",11,2016,mid,40000000,0,1663785,1663785,-38336215,4.1594625
The Last Exorcism Part II,"Drama,Horror,Thriller",Drama,"['Horror', 'Thriller']",3,2013,low,4000000,15179303,10269404,25448707,21448707,636.217675
"Pink Ribbons, Inc.",Documentary,Documentary,[],6,2012,low,1200000,26608,0,26608,-1173392,2.2173333333333334
Flatliners,"Drama,Horror,Mystery",Drama,"['Horror', 'Mystery']",9,2017,mid,20000000,16883115,28290623,45173738,25173738,225.86869
Inside Llewyn Davis,"Drama,Music",Drama,['Music'],12,2013,mid,11000000,13248209,19695038,32943247,21943247,299.48406363636366
Alice in Wonderland,"Fantasy,Musical",Fantasy,['Musical'],3,2010,high,200000000,334191110,691300000,1025491110,825491110,512.745555
Home Run,"Drama,Sport",Drama,['Sport'],4,2013,low,1200000,2859955,0,2859955,1659955,238.32958333333335
Water & Power,"Crime,Drama",Crime,['Drama'],5,2014,low,600000,42557,0,42557,-557443,7.092833333333333
Side Effects,"Crime,Drama,Mystery",Crime,"['Drama', 'Mystery']",2,2013,mid,30000000,32172757,34569381,66742138,36742138,222.47379333333333
Eye in the Sky,"Drama,Thriller,War",Drama,"['Thriller', 'War']",3,2016,mid,13000000,18704596,16698206,35402802,22402802,272.32924615384616
The Railway Man,"Biography,Drama,Romance",Biography,"['Drama', 'Romance']",4,2014,mid,18000000,4438438,19471772,23910210,5910210,132.83450000000002
Point Break,"Action,Crime,Sport",Action,"['Crime', 'Sport']",12,2015,high,100000000,28782481,97922110,126704591,26704591,126.704591
13 Sins,"Horror,Thriller",Horror,['Thriller'],4,2014,low,4000000,9134,38418,47552,-3952448,1.1887999999999999
Rocketman,"Biography,Drama,Music",Biography,"['Drama', 'Music']",5,2019,mid,41000000,57342725,51300000,108642725,67642725,264.982256097561
Dangerous Liaisons,"Drama,Mystery,Romance",Drama,"['Mystery', 'Romance']",11,2012,mid,24200000,17000,10430579,10447579,-13752421,43.17181404958678
Holy Motors,"Drama,Fantasy",Drama,['Fantasy'],10,2012,low,4000000,641054,3589372,4230426,230426,105.76064999999998
Steve Jobs,"Biography,Drama",Biography,['Drama'],10,2015,mid,30000000,17766658,17812349,35579007,5579007,118.59669
The Best Man Holiday,"Comedy,Drama",Comedy,['Drama'],11,2013,mid,17000000,70525195,2310515,72835710,55835710,428.44535294117645
Trouble with the Curve,"Drama,Sport",Drama,['Sport'],9,2012,high,60000000,35763137,12055776,47818913,-12181087,79.69818833333333
The Imitation Game,"Biography,Drama,Thriller",Biography,"['Drama', 'Thriller']",11,2014,mid,15000000,91125143,136615320,227740463,212740463,1518.2697533333335
Captain Underpants: The First Epic Movie,"Action,Animation,Comedy",Action,"['Animation', 'Comedy']",6,2017,mid,38000000,73921000,52656874,126577874,88577874,333.0996684210526
Grace of Monaco,"Biography,Drama,Romance",Biography,"['Drama', 'Romance']",12,2015,mid,30000000,0,25199891,25199891,-4800109,83.99963666666666
Dumb and Dumber To,"Adventure,Comedy",Adventure,['Comedy'],11,2014,mid,40000000,86208010,70345582,156553592,116553592,391.38398
"McFarland, USA","Biography,Drama,Sport",Biography,"['Drama', 'Sport']",2,2015,mid,17000000,44480275,1227649,45707924,28707924,268.8701411764706
A.C.O.R.N.S.: Operation Crackdown,"Animation,Comedy,Family",Animation,"['Comedy', 'Family']",11,2016,mid,8500000,0,1353287,1353287,-7146713,15.921023529411766
Antiviral,"Horror,Sci-Fi,Thriller",Horror,"['Sci-Fi', 'Thriller']",4,2013,low,3100000,0,123407,123407,-2976593,3.9808709677419354
Dead Man Down,"Action,Crime,Drama",Action,"['Crime', 'Drama']",3,2013,mid,30000000,10895295,8704679,19599974,-10400026,65.33324666666667
Spring Breakers,"Comedy,Crime,Drama",Comedy,"['Crime', 'Drama']",3,2013,mid,5000000,14124286,17024965,31149251,26149251,622.98502
Tammy,"Comedy,Romance",Comedy,['Romance'],7,2014,mid,20000000,84525432,11882223,96407655,76407655,482.038275
Dawn of the Planet of the Apes,"Action,Adventure,Drama",Action,"['Adventure', 'Drama']",7,2014,high,170000000,208545589,502098977,710644566,540644566,418.0262152941176
Into the Storm,"Action,Adventure,Drama",Action,"['Adventure', 'Drama']",8,2014,high,50000000,47602194,102827177,150429371,100429371,300.858742
Noah,"Drama,Thriller",Drama,['Thriller'],3,2014,high,130000000,101200044,251631021,352831065,222831065,271.40851153846154
Paranormal Activity 4,"Horror,Mystery,Thriller",Horror,"['Mystery', 'Thriller']",10,2012,mid,5000000,53900335,88917657,142817992,137817992,2856.35984
Transformers: Age of Extinction,"Action,Adventure,Sci-Fi",Action,"['Adventure', 'Sci-Fi']",6,2014,high,210000000,245439076,858600000,1104039076,894039076,525.7328933333333
Swelter,"Action,Crime,Drama",Action,"['Crime', 'Drama']",8,2014,mid,8000000,0,44197,44197,-7955803,0.5524625
Elsa & Fred,"Comedy,Drama,Romance",Comedy,"['Drama', 'Romance']",11,2014,mid,10000000,67657,130244,197901,-9802099,1.9790100000000002
Hacksaw Ridge,"Biography,Drama,History",Biography,"['Drama', 'History']",11,2016,mid,40000000,67209615,101695067,168904682,128904682,422.261705
Pixels,"Action,Comedy,Sci-Fi",Action,"['Comedy', 'Sci-Fi']",7,2015,high,90000000,78765986,165275818,244041804,154041804,271.15756000000005
Beasts of the Southern Wild,"Adventure,Drama,Fantasy",Adventure,"['Drama', 'Fantasy']",6,2012,low,1800000,12795746,10469386,23265132,21465132,1292.5073333333335
Collide,"Action,Crime,Thriller",Action,"['Crime', 'Thriller']",2,2017,mid,29200000,2280004,3186694,5466698,-23733302,18.721568493150684
San Andreas,"Action,Adventure,Drama",Action,"['Adventure', 'Drama']",5,2015,high,110000000,155190832,301067707,456258539,346258539,414.78049
Second Act,"Comedy,Drama,Romance",Comedy,"['Drama', 'Romance']",12,2018,mid,15700000,39282227,24006627,63288854,47588854,403.1137197452229
Jane Got a Gun,"Action,Drama,Western",Action,"['Drama', 'Western']",1,2016,mid,25000000,1513793,2257552,3771345,-21228655,15.08538
Saving Mr. Banks,"Biography,Comedy,Drama",Biography,"['Comedy', 'Drama']",12,2013,mid,35000000,83299761,31662764,114962525,79962525,328.4643571428572
The Accountant,"Action,Crime,Drama",Action,"['Crime', 'Drama']",10,2016,mid,40000000,86260045,66702038,152962083,112962083,382.4052075
Two Night Stand,"Comedy,Romance",Comedy,['Romance'],9,2014,low,1600000,15600,852481,868081,-731919,54.255062499999994
Food Chains,Documentary,Documentary,[],11,2014,low,913000,0,176,176,-912824,0.019277108433734938
Black November,"Action,Crime,Drama",Action,"['Crime', 'Drama']",1,2015,mid,7500000,0,32572,32572,-7467428,0.4342933333333333
Khiladi 786,"Action,Comedy",Action,['Comedy'],12,2012,mid,5600000,385422,14298341,14683763,9083763,262.2100535714286
Bad Words,"Comedy,Drama",Comedy,['Drama'],3,2014,mid,10000000,7779614,63531,7843145,-2156855,78.43145
Horrible Bosses 2,"Comedy,Crime",Comedy,['Crime'],11,2014,mid,40000000,54445357,51500000,105945357,65945357,264.8633925
St. Vincent,"Comedy,Drama",Comedy,['Drama'],10,2014,mid,13000000,44137712,10699522,54837234,41837234,421.8248769230769
The Foreigner,"Comedy,Romance",Comedy,['Romance'],10,2017,mid,35000000,34393507,106389853,140783360,105783360,402.23817142857143
3 Days to Kill,"Action,Drama,Thriller",Action,"['Drama', 'Thriller']",2,2014,mid,28000000,30697999,8261901,38959900,10959900,139.14249999999998
Metallica Through the Never,Music,Music,[],9,2013,mid,18000000,3419967,5662939,9082906,-8917094,50.46058888888889
Jab Tak Hai Jaan,"Drama,Romance",Drama,['Romance'],11,2012,mid,9200000,3047539,2759127,5806666,-3393334,63.1159347826087
As It Is in Heaven,Drama,Drama,[],7,2014,low,450000,13486,0,13486,-436514,2.996888888888889
The Monuments Men,"Comedy,Drama,History",Comedy,"['Drama', 'History']",2,2014,high,70000000,78031620,80671128,158702748,88702748,226.71821142857144
Yeh Jawaani Hai Deewani,"Comedy,Drama,Musical",Comedy,"['Drama', 'Musical']",5,2013,mid,8300000,3827466,47000000,50827466,42527466,612.3791084337349
American Sniper,"Action,Biography,Drama",Action,"['Biography', 'Drama']",12,2014,high,58000000,350126372,197200000,547326372,489326372,943.6661586206898
Jackie,"Comedy,Drama,Romance",Comedy,"['Drama', 'Romance']",12,2016,mid,9000000,13960394,22628118,36588512,27588512,406.5390222222222
Song One,"Drama,Music",Drama,['Music'],1,2015,mid,6000000,32251,404838,437089,-5562911,7.284816666666667
Earth to Echo,"Adventure,Family,Sci-Fi",Adventure,"['Family', 'Sci-Fi']",7,2014,mid,13000000,38934842,3239703,42174545,29174545,324.41957692307693
The Purge,"Horror,Thriller",Horror,['Thriller'],6,2013,low,3000000,64473115,26793466,91266581,88266581,3042.2193666666667
Escape from Tomorrow,"Drama,Fantasy,Horror",Drama,"['Fantasy', 'Horror']",10,2013,low,650000,171962,0,171962,-478038,26.455692307692306
Grown Ups 2,Comedy,Comedy,[],7,2013,high,80000000,133668525,113355283,247023808,167023808,308.77976
The Counselor,"Crime,Drama,Thriller",Crime,"['Drama', 'Thriller']",10,2013,mid,25000000,16973715,54035619,71009334,46009334,284.037336
About Time,"Comedy,Drama,Fantasy",Comedy,"['Drama', 'Fantasy']",11,2013,mid,12000000,15323921,73985257,89309178,77309178,744.24315
Run All Night,"Action,Drama,Thriller",Action,"['Drama', 'Thriller']",3,2015,high,50000000,26461644,40500000,66961644,16961644,133.92328799999999
The Other Woman,"Comedy,Romance",Comedy,['Romance'],4,2014,mid,40000000,83911193,111200000,195111193,155111193,487.7779825
Before Midnight,"Drama,Romance",Drama,['Romance'],5,2013,low,3000000,8110621,15141309,23251930,20251930,775.0643333333334
Katy Perry: Part of Me,"Documentary,Music",Documentary,['Music'],7,2012,mid,12000000,25326071,7374368,32700439,20700439,272.50365833333336
Now You See Me,"Drama,Horror,Thriller",Drama,"['Horror', 'Thriller']",5,2013,high,75000000,117723989,225045211,342769200,267769200,457.02559999999994
Draft Day,"Drama,Sport",Drama,['Sport'],4,2014,mid,25000000,28842237,1005243,29847480,4847480,119.38991999999999
Plush,"Drama,Music,Thriller",Drama,"['Music', 'Thriller']",9,2013,low,2000000,3080,25784,28864,-1971136,1.4432
Don Jon,"Comedy,Drama,Romance",Comedy,"['Drama', 'Romance']",9,2013,mid,5500000,24477704,16790875,41268579,35768579,750.3378
Wild Card,"Action,Crime,Drama",Action,"['Crime', 'Drama']",1,2015,mid,30000000,3200,4312589,4315789,-25684211,14.385963333333333
Rampage,"Action,Adventure,Sci-Fi",Action,"['Adventure', 'Sci-Fi']",4,2018,high,120000000,101028233,327028047,428056280,308056280,356.7135666666667
The Internship,Comedy,Comedy,[],6,2013,high,58000000,44672764,49000000,93672764,35672764,161.50476551724137
Dear White People,"Comedy,Drama,Romance",Comedy,"['Drama', 'Romance']",10,2014,low,1250000,4404154,999617,5403771,4153771,432.30168000000003
Valerian and the City of a Thousand Planets,"Action,Adventure,Fantasy",Action,"['Adventure', 'Fantasy']",7,2017,high,180000000,40479370,174618986,215098356,35098356,119.49908666666667
Think Like a Man Too,"Comedy,Romance",Comedy,['Romance'],6,2014,mid,24000000,65028687,4999246,70027933,46027933,291.78305416666666
Money Monster,"Crime,Drama,Thriller",Crime,"['Drama', 'Thriller']",5,2016,mid,27000000,41012075,52454020,93466095,66466095,346.1707222222222
A Haunted House,"Comedy,Fantasy",Comedy,['Fantasy'],1,2013,low,2500000,40041683,19880875,59922558,57422558,2396.9023199999997
Big Hero 6,"Action,Adventure,Animation",Action,"['Adventure', 'Animation']",11,2014,high,165000000,222527828,429600000,652127828,487127828,395.2289866666667
Born to Fly: Elizabeth Streb vs. Gravity,"Action,Biography,Documentary",Action,"['Biography', 'Documentary']",9,2014,low,500000,1822,0,1822,-498178,0.3644
When the Game Stands Tall,"Drama,Family,Sport",Drama,"['Family', 'Sport']",8,2014,mid,15000000,30127963,10949,30138912,15138912,200.92607999999998
Zulu,"Crime,Drama,Thriller",Crime,"['Drama', 'Thriller']",12,2013,mid,16000000,0,1844228,1844228,-14155772,11.526425
Spider-Man: Homecoming,"Action,Adventure,Sci-Fi",Action,"['Adventure', 'Sci-Fi']",7,2017,high,175000000,334201140,545965210,880166350,705166350,502.9522
Ride Along,Action,Action,[],1,2014,mid,25000000,134202565,19531235,153733800,128733800,614.9352
Drinking Buddies,"Comedy,Drama,Romance",Comedy,"['Drama', 'Romance']",8,2013,low,500000,343706,63394,407100,-92900,81.42
Kung Fu Panda 3,"Action,Adventure,Animation",Action,"['Adventure', 'Animation']",1,2016,high,140000000,143528619,374070523,517599142,377599142,369.71367285714285
Gone Girl,"Drama,Mystery,Thriller",Drama,"['Mystery', 'Thriller']",10,2014,high,61000000,167767189,200800000,368567189,307567189,604.2085065573771
Magic Mike XXL,"Comedy,Drama,Music",Comedy,"['Drama', 'Music']",7,2015,mid,14500000,66013057,57647540,123660597,109160597,852.8317034482759
Hellboy,"Action,Adventure,Fantasy",Action,"['Adventure', 'Fantasy']",4,2019,high,50000000,21903748,18821744,40725492,-9274508,81.450984
Finding Dory,"Adventure,Animation,Comedy",Adventure,"['Animation', 'Comedy']",6,2016,high,200000000,486295561,534919632,1021215193,821215193,510.60759649999994
The Grand Budapest Hotel,"Adventure,Comedy,Crime",Adventure,"['Comedy', 'Crime']",3,2014,mid,31000000,59076019,104905242,163981261,132981261,528.9718096774194
Love the Coopers,"Comedy,Fantasy,Romance",Comedy,"['Fantasy', 'Romance']",11,2015,mid,18000000,26302731,15924759,42227490,24227490,234.59716666666668
The SpongeBob Movie: Sponge Out of Water,"Adventure,Animation,Comedy",Adventure,"['Animation', 'Comedy']",2,2015,high,74000000,162994032,148019149,311013181,237013181,420.2880824324325
Muppets Most Wanted,"Adventure,Comedy,Crime",Adventure,"['Comedy', 'Crime']",3,2014,high,55000000,51178893,28133408,79312301,24312301,144.20418363636364
Men in Black: International,"Action,Adventure,Comedy",Action,"['Adventure', 'Comedy']",6,2019,high,110000000,3100000,0,3100000,-106900000,2.8181818181818183
Jumanji: Welcome to the Jungle,"Action,Adventure,Comedy",Action,"['Adventure', 'Comedy']",12,2017,high,90000000,404508916,559987277,964496193,874496193,1071.6624366666667
Along the Roadside,"Comedy,Music,Romance",Comedy,"['Music', 'Romance']",3,2015,low,250000,0,3234,3234,-246766,1.2935999999999999
The Canyons,"Drama,Thriller",Drama,['Thriller'],8,2013,low,250000,59671,2704,62375,-187625,24.95
Minions,"Adventure,Animation,Comedy",Adventure,"['Animation', 'Comedy']",7,2015,high,74000000,336045770,824290403,1160336173,1086336173,1568.0218554054054
22 Jump Street,"Action,Comedy,Crime",Action,"['Comedy', 'Crime']",6,2014,high,50000000,191719337,139614539,331333876,281333876,662.6677520000001
Frozen,"Adventure,Animation,Comedy",Adventure,"['Animation', 'Comedy']",11,2013,high,150000000,400738009,871731901,1272469910,1122469910,848.3132733333333
Falcon Rising,"Action,Adventure",Action,['Adventure'],9,2014,low,4500000,11774,0,11774,-4488226,0.2616444444444444
Sherlock Gnomes,"Adventure,Animation,Comedy",Adventure,"['Animation', 'Comedy']",3,2018,high,59000000,43242871,44284780,87527651,28527651,148.35195084745763
Olympus Has Fallen,"Action,Thriller",Action,['Thriller'],3,2013,high,70000000,98927592,73951336,172878928,102878928,246.96989714285715
23 Blast,"Drama,Family,Sport",Drama,"['Family', 'Sport']",10,2014,low,1000000,549185,0,549185,-450815,54.9185
Mandela: Long Walk to Freedom,"Biography,Drama,History",Biography,"['Drama', 'History']",11,2013,mid,35000000,8323085,21567317,29890402,-5109598,85.40114857142858
The 5th Wave,"Action,Adventure,Drama",Action,"['Adventure', 'Drama']",1,2016,mid,38000000,34912982,76423416,111336398,73336398,292.99052105263155
The Gallows,"Horror,Mystery,Thriller",Horror,"['Mystery', 'Thriller']",7,2015,low,100000,22764410,18892064,41656474,41556474,41656.473999999995
The Gatekeepers,"Documentary,History,War",Documentary,"['History', 'War']",2,2013,low,1500000,2408553,183755,2592308,1092308,172.82053333333334
The Hobbit: The Battle of the Five Armies,"Adventure,Fantasy",Adventure,['Fantasy'],12,2014,high,250000000,255119788,690457833,945577621,695577621,378.23104839999996
Windsor Drive,"Mystery,Thriller",Mystery,['Thriller'],8,2015,low,850000,3256,0,3256,-846744,0.3830588235294118
Alien: Covenant,"Horror,Sci-Fi,Thriller",Horror,"['Sci-Fi', 'Thriller']",5,2017,high,97000000,74262031,164259216,238521247,141521247,245.89819278350515
Endless Love,"Drama,Romance",Drama,['Romance'],2,2014,mid,20000000,23438250,11279923,34718173,14718173,173.590865
ABCD (Any Body Can Dance),"Drama,Music",Drama,['Music'],2,2013,low,1900000,222098,9915136,10137234,8237234,533.5386315789474
The Babadook,"Drama,Horror",Drama,['Horror'],11,2014,low,2000000,950792,6531595,7482387,5482387,374.11935
Fifty Shades of Grey,"Drama,Romance,Thriller",Drama,"['Romance', 'Thriller']",2,2015,mid,40000000,166167230,404830871,570998101,530998101,1427.4952524999999
Strangerland,"Drama,Mystery,Thriller",Drama,"['Mystery', 'Thriller']",7,2015,mid,10000000,17472,143625,161097,-9838903,1.61097
Mary Queen of Scots,"Biography,Drama,History",Biography,"['Drama', 'History']",12,2018,mid,25000000,16468499,30266234,46734733,21734733,186.938932
No Escape,"Documentary,Music",Documentary,['Music'],8,2015,mid,5000000,27288872,15555644,42844516,37844516,856.89032
The Expendables 3,"Action,Adventure,Thriller",Action,"['Adventure', 'Thriller']",8,2014,high,100000000,39322544,170138834,209461378,109461378,209.461378
Fruitvale Station,"Biography,Drama,Romance",Biography,"['Drama', 'Romance']",7,2013,low,900000,16098998,1450647,17549645,16649645,1949.9605555555554
Blue Jasmine,Drama,Drama,[],7,2013,mid,18000000,33404871,69508090,102912961,84912961,571.7386722222221
White House Down,"Action,Drama,Thriller",Action,"['Drama', 'Thriller']",6,2013,high,150000000,73103784,132336603,205440387,55440387,136.960258
Parkland,"Drama,History,Mystery",Drama,"['History', 'Mystery']",10,2013,mid,10000000,641439,974914,1616353,-8383647,16.16353
The Rover,"Action,Crime,Drama",Action,"['Crime', 'Drama']",6,2014,mid,8500000,1109199,2071053,3180252,-5319748,37.41472941176471
The Mummy,"Action,Adventure,Fantasy",Action,"['Adventure', 'Fantasy']",6,2017,high,195000000,80101125,329852780,409953905,214953905,210.2327717948718
Frances Ha,"Comedy,Drama,Romance",Comedy,"['Drama', 'Romance']",5,2013,low,3000000,4067398,7195371,11262769,8262769,375.42563333333334
Grace Unplugged,"Drama,Music",Drama,['Music'],10,2013,low,1700000,2507159,0,2507159,807159,147.4799411764706
The Lunchbox,"Drama,Romance",Drama,['Romance'],2,2014,low,1700000,4231500,8000000,12231500,10531500,719.5
Stone,"Action,Sci-Fi",Action,['Sci-Fi'],10,2010,mid,22000000,1810078,2254942,4065020,-17934980,18.477363636363638
Jobs,"Biography,Drama",Biography,['Drama'],8,2013,mid,18000000,16131410,27271105,43402515,25402515,241.12508333333332
Rio 2,"Adventure,Animation,Comedy",Adventure,"['Animation', 'Comedy']",4,2014,high,130000000,131538435,361307856,492846291,362846291,379.11253153846155
Blue Ruin,"Crime,Drama,Thriller",Crime,"['Drama', 'Thriller']",4,2014,low,420000,258384,178618,437002,17002,104.04809523809524
Live by Night,"Action,Crime,Drama",Action,"['Crime', 'Drama']",12,2016,high,65000000,10378555,11395877,21774432,-43225568,33.499126153846156
The Intern,"Comedy,Drama",Comedy,['Drama'],9,2015,mid,40000000,75764672,121351038,197115710,157115710,492.789275
Antarctica: A Year on Ice,"Adventure,Biography,Documentary",Adventure,"['Biography', 'Documentary']",11,2014,low,1000000,288757,0,288757,-711243,28.8757
Runner Runner,"Crime,Thriller",Crime,['Thriller'],10,2013,mid,30000000,19316646,41196034,60512680,30512680,201.70893333333333
The Disappointments Room,"Drama,Horror,Thriller",Drama,"['Horror', 'Thriller']",9,2016,mid,15000000,2423467,1080294,3503761,-11496239,23.358406666666667
Lost River,"Drama,Fantasy,Mystery",Drama,"['Fantasy', 'Mystery']",4,2015,low,2000000,45431,1964213,2009644,9644,100.4822
Need for Speed,"Action,Crime,Thriller",Action,"['Crime', 'Thriller']",3,2014,high,66000000,43568507,150601112,194169619,128169619,294.19639242424245
The Act of Killing,"Crime,Documentary",Crime,['Documentary'],7,2013,low,1000000,486919,740397,1227316,227316,122.73160000000001
Deliver Us from Evil,"Horror,Mystery,Thriller",Horror,"['Mystery', 'Thriller']",7,2014,mid,30000000,30577122,57379496,87956618,57956618,293.18872666666664
Spectre,"Action,Adventure,Thriller",Action,"['Adventure', 'Thriller']",11,2015,high,300000000,200074175,679546748,879620923,579620923,293.20697433333333
How to Train Your Dragon: The Hidden World,"Action,Adventure,Animation",Action,"['Adventure', 'Animation']",2,2019,high,129000000,160791800,358466483,519258283,390258283,402.5258007751938
Dark Skies,"Horror,Sci-Fi,Thriller",Horror,"['Sci-Fi', 'Thriller']",2,2013,low,3500000,17418667,10285444,27704111,24204111,791.5460285714286
Delivery Man,"Comedy,Drama",Comedy,['Drama'],11,2013,mid,22000000,30659817,39877053,70536870,48536870,320.62213636363634
Flipped,"Drama,Thriller",Drama,['Thriller'],8,2010,mid,14000000,1755212,2534781,4289993,-9710007,30.642807142857144
Ain't Them Bodies Saints,"Crime,Drama,Romance",Crime,"['Drama', 'Romance']",8,2013,mid,5000000,391611,683398,1075009,-3924991,21.50018
Oculus,"Horror,Mystery",Horror,['Mystery'],4,2014,mid,5000000,27695246,16420250,44115496,39115496,882.3099199999999
Cheap Thrills,"Comedy,Crime,Drama",Comedy,"['Crime', 'Drama']",3,2014,low,100000,59424,0,59424,-40576,59.424
Enough Said,"Comedy,Drama,Romance",Comedy,"['Drama', 'Romance']",9,2013,mid,8000000,17550872,8070577,25621449,17621449,320.2681125
Kursk,Drama,Drama,[],6,2019,mid,40000000,0,4212799,4212799,-35787201,10.5319975
Avengers: Age of Ultron,"Action,Adventure,Sci-Fi",Action,"['Adventure', 'Sci-Fi']",5,2015,high,330600000,459005868,944008095,1403013963,1072413963,424.3841388384755
The Homesman,"Drama,Western",Drama,['Western'],11,2014,mid,16000000,2429989,5787582,8217571,-7782429,51.359818749999995
Smurfs: The Lost Village,"Adventure,Animation,Comedy",Adventure,"['Animation', 'Comedy']",4,2017,high,60000000,45020282,152558304,197578586,137578586,329.2976433333333
They Came Together,"Comedy,Romance",Comedy,['Romance'],6,2014,low,3000000,0,82780,82780,-2917220,2.7593333333333336
Anomalisa,"Animation,Comedy,Drama",Animation,"['Comedy', 'Drama']",12,2015,mid,8000000,3759286,1946882,5706168,-2293832,71.3271
Dom Hemingway,"Comedy,Crime,Drama",Comedy,"['Crime', 'Drama']",4,2014,mid,7000000,523511,1333947,1857458,-5142542,26.535114285714283
The November Man,"Action,Crime,Thriller",Action,"['Crime', 'Thriller']",8,2014,mid,15000000,25018119,9802216,34820335,19820335,232.13556666666668
Carol,"Drama,Romance",Drama,['Romance'],11,2015,mid,11800000,12711491,30132030,42843521,31043521,363.080686440678
The Green Inferno,"Adventure,Horror",Adventure,['Horror'],9,2015,low,1000000,7192291,5739129,12931420,11931420,1293.1419999999998
Desert Dancer,"Biography,Drama,Music",Biography,"['Drama', 'Music']",4,2015,low,4000000,155271,441064,596335,-3403665,14.908375
Gods of Egypt,"Action,Adventure,Fantasy",Action,"['Adventure', 'Fantasy']",2,2016,high,140000000,31153464,107683292,138836756,-1163244,99.16911142857143
Woman in Gold,"Biography,Drama,History",Biography,"['Drama', 'History']",4,2015,mid,11000000,33307793,25278614,58586407,47586407,532.6037
The Magnificent Seven,"Action,Adventure,Western",Action,"['Adventure', 'Western']",9,2016,high,90000000,93432655,69092501,162525156,72525156,180.58350666666666
The Heat,"Action,Comedy,Crime",Action,"['Comedy', 'Crime']",6,2013,mid,43000000,159581587,70146187,229727774,186727774,534.2506372093023
Atomic Blonde,"Action,Mystery,Thriller",Action,"['Mystery', 'Thriller']",7,2017,mid,30000000,51573925,46771498,98345423,68345423,327.8180766666666
Killers,"Action,Crime,Drama",Action,"['Crime', 'Drama']",6,2010,high,75000000,47059963,48512786,95572749,20572749,127.430332
The Campaign,Documentary,Documentary,[],8,2012,high,95000000,86907746,18000000,104907746,9907746,110.42920631578947
Butterfly Girl,Documentary,Documentary,[],2,2015,low,180000,17503,0,17503,-162497,9.723888888888888
Philomena,"Biography,Comedy,Drama",Biography,"['Comedy', 'Drama']",11,2013,mid,12000000,37709979,61253413,98963392,86963392,824.6949333333333
Project Almanac,"Drama,Mystery,Sci-Fi",Drama,"['Mystery', 'Sci-Fi']",1,2015,mid,12000000,22348241,10561196,32909437,20909437,274.24530833333336
Taken 3,"Action,Thriller",Action,['Thriller'],1,2015,mid,48000000,89256424,238400000,327656424,279656424,682.6175499999999
The Peanuts Movie,"Adventure,Animation,Comedy",Adventure,"['Animation', 'Comedy']",11,2015,high,99000000,130178411,119913199,250091610,151091610,252.61778787878785
Mi America,"Crime,Drama",Crime,['Drama'],10,2016,low,2100000,3330,0,3330,-2096670,0.15857142857142859
And So It Goes,"Comedy,Drama,Romance",Comedy,"['Drama', 'Romance']",7,2014,mid,18000000,15160801,2759212,17920013,-79987,99.55562777777777
Paranormal Activity: The Ghost Dimension,"Horror,Mystery,Thriller",Horror,"['Mystery', 'Thriller']",10,2015,mid,10000000,18297124,59662250,77959374,67959374,779.59374
Get on Up,"Biography,Drama,Music",Biography,"['Drama', 'Music']",8,2014,mid,30000000,30569935,2769933,33339868,3339868,111.13289333333334
Paranormal Activity: The Marked Ones,"Horror,Mystery,Thriller",Horror,"['Mystery', 'Thriller']",1,2014,mid,5000000,32462372,58442482,90904854,85904854,1818.09708
Mr. Turner,"Biography,Drama,History",Biography,"['Drama', 'History']",12,2014,mid,14000000,3958546,21228480,25187026,11187026,179.90732857142856
The Last Five Years,"Comedy,Drama,Musical",Comedy,"['Drama', 'Musical']",2,2015,low,2000000,147299,57999,205298,-1794702,10.2649
Palo Alto,Drama,Drama,[],5,2014,low,1000000,767732,388577,1156309,156309,115.6309
Bone Tomahawk,"Adventure,Drama,Horror",Adventure,"['Drama', 'Horror']",10,2015,low,2000000,0,475846,475846,-1524154,23.7923
Aloft,Drama,Drama,[],5,2015,mid,8000000,53086,184602,237688,-7762312,2.9711000000000003
Speak No Evil,Horror,Horror,[],12,2013,low,150000,0,32927,32927,-117073,21.951333333333334
Broken Horses,"Action,Crime,Drama",Action,"['Crime', 'Drama']",9,2015,mid,15000000,0,3471,3471,-14996529,0.023139999999999997
Hotel Transylvania 2,"Animation,Comedy,Family",Animation,"['Comedy', 'Family']",9,2015,high,80000000,169700110,299800188,469500298,389500298,586.8753725
Mud,Drama,Drama,[],4,2013,mid,10000000,21590086,9966873,31556959,21556959,315.56959
Escobar: Paradise Lost,"Crime,Drama,History",Crime,"['Drama', 'History']",6,2015,mid,17000000,195792,3721887,3917679,-13082321,23.045170588235294
Blockers,Comedy,Comedy,[],4,2018,mid,21000000,60311495,33733833,94045328,73045328,447.8348952380952
Wonder,"Drama,Family",Drama,['Family'],11,2017,mid,20000000,132422809,172181903,304604712,284604712,1523.02356
The Light Between Oceans,"Drama,Romance",Drama,['Romance'],9,2016,mid,20000000,12545979,9735753,22281732,2281732,111.40866
"Cinco de Mayo, La Batalla","Drama,History,War",Drama,"['History', 'War']",5,2013,mid,10000000,173472,0,173472,-9826528,1.73472
Crimson Peak,"Drama,Fantasy,Horror",Drama,"['Fantasy', 'Horror']",10,2015,high,55000000,31090320,43876534,74966854,19966854,136.30337090909092
The Second Best Exotic Marigold Hotel,"Comedy,Drama",Comedy,['Drama'],3,2015,mid,10000000,33078266,57306040,90384306,80384306,903.84306
Plastic,"Action,Comedy,Crime",Action,"['Comedy', 'Crime']",9,2014,mid,10000000,0,575371,575371,-9424629,5.75371
Pacific Rim: Uprising,"Action,Adventure,Sci-Fi",Action,"['Adventure', 'Sci-Fi']",3,2018,high,155000000,59874525,231055623,290930148,135930148,187.69686967741936
Homefront,Drama,Drama,[],11,2013,mid,22000000,20158492,31536870,51695362,29695362,234.9789181818182
Ballerina,"Biography,Documentary",Biography,['Documentary'],8,2017,mid,30000000,21858070,75034759,96892829,66892829,322.97609666666665
Birdman or (The Unexpected Virtue of Ignorance),"Comedy,Drama",Comedy,['Drama'],10,2014,mid,18000000,42340598,60874496,103215094,85215094,573.4171888888889
Alice Through the Looking Glass,"Adventure,Family,Fantasy",Adventure,"['Family', 'Fantasy']",5,2016,high,170000000,77042381,199885731,276928112,106928112,162.8988894117647
Going in Style,"Comedy,Crime",Comedy,['Crime'],4,2017,mid,24000000,45018541,33654038,78672579,54672579,327.8024125
Me and Earl and the Dying Girl,"Comedy,Drama,Romance",Comedy,"['Drama', 'Romance']",6,2015,mid,8000000,6758416,2507764,9266180,1266180,115.82725
Shut In,"Drama,Mystery,Thriller",Drama,"['Mystery', 'Thriller']",11,2016,mid,10000000,6900335,4460330,11360665,1360665,113.60665
Hell or High Water,"Action,Crime,Drama",Action,"['Crime', 'Drama']",8,2016,mid,12000000,27007844,10576460,37584304,25584304,313.20253333333335
Whiplash,"Drama,Music",Drama,['Music'],10,2014,low,3300000,13092006,25877031,38969037,35669037,1180.879909090909
The Fault in Our Stars,"Drama,Romance",Drama,['Romance'],6,2014,mid,12000000,124872350,182294484,307166834,295166834,2559.7236166666667
Resident Evil: The Final Chapter,"Action,Horror,Sci-Fi",Action,"['Horror', 'Sci-Fi']",1,2017,mid,40000000,26844692,287256498,314101190,274101190,785.252975
Kevin Hart: Let Me Explain,"Comedy,Documentary",Comedy,['Documentary'],7,2013,low,2500000,32244051,83204,32327255,29827255,1293.0901999999999
Pump,Documentary,Documentary,[],9,2014,low,2000000,72277,0,72277,-1927723,3.61385
Baahubali: The Beginning,"Action,Drama",Action,['Drama'],7,2015,mid,40000000,6738000,19998665,26736665,-13263335,66.8416625
Ted 2,Comedy,Comedy,[],6,2015,high,68000000,81476385,135737758,217214143,149214143,319.43256323529414
Hot Tub Time Machine 2,"Comedy,Mystery,Sci-Fi",Comedy,"['Mystery', 'Sci-Fi']",2,2015,mid,14000000,12314651,511993,12826644,-1173356,91.61888571428571
Ben-Hur,"Action,Adventure,Drama",Action,"['Adventure', 'Drama']",8,2016,high,95000000,26410477,65259171,91669648,-3330352,96.49436631578948
Midnight Special,"Action,Drama,Mystery",Action,"['Drama', 'Mystery']",3,2016,mid,18000000,3712282,3967968,7680250,-10319750,42.668055555555554
Deceptive Practice: The Mysteries and Mentors of Ricky Jay,Documentary,Documentary,[],4,2013,low,500000,152449,0,152449,-347551,30.4898
Star Trek Beyond,"Action,Adventure,Sci-Fi",Action,"['Adventure', 'Sci-Fi']",7,2016,high,185000000,158848340,176953893,335802233,150802233,181.51472054054054
Miss Julie,"Drama,Romance",Drama,['Romance'],5,2015,mid,5500000,0,863895,863895,-4636105,15.707181818181818
Me Before You,"Drama,Romance",Drama,['Romance'],6,2016,mid,20000000,56245075,152020123,208265198,188265198,1041.32599
Hitman: Agent 47,"Action,Adventure,Crime",Action,"['Adventure', 'Crime']",8,2015,mid,35000000,22467450,59715353,82182803,47182803,234.8080085714286
The D Train,"Comedy,Drama",Comedy,['Drama'],5,2015,low,3000000,669688,102678,772366,-2227634,25.74553333333333
Night at the Museum: Secret of the Tomb,"Adventure,Comedy,Family",Adventure,"['Comedy', 'Family']",12,2014,high,127000000,113746621,240010000,353756621,226756621,278.54852047244094
Locke,Drama,Drama,[],4,2014,low,2000000,1370646,717744,2088390,88390,104.4195
The Debt,"Drama,Mystery,Thriller",Drama,"['Mystery', 'Thriller']",8,2011,mid,20000000,31177548,15426506,46604054,26604054,233.02027
Long Shot,"Biography,Documentary",Biography,['Documentary'],5,2019,mid,40000000,30202860,13508171,43711031,3711031,109.2775775
The Boss,Comedy,Comedy,[],4,2016,mid,29000000,63077560,15574647,78652207,49652207,271.2145068965517
Game Night,"Action,Comedy,Crime",Action,"['Comedy', 'Crime']",2,2018,mid,37000000,69179066,48199018,117378084,80378084,317.23806486486484
The Secret Life of Pets,"Adventure,Animation,Comedy",Adventure,"['Animation', 'Comedy']",7,2016,high,75000000,368384330,518366204,886750534,811750534,1182.3340453333333
Fury,"Action,Drama,War",Action,"['Drama', 'War']",10,2014,high,80000000,85817906,124497775,210315681,130315681,262.89460125
Blackhat,"Action,Crime,Thriller",Action,"['Crime', 'Thriller']",1,2015,high,70000000,8005980,11659024,19665004,-50334996,28.09286285714286
Ida,Drama,Drama,[],5,2014,low,2600000,3827060,11471295,15298355,12698355,588.3982692307693
Everest,"Action,Adventure,Biography",Action,"['Adventure', 'Biography']",9,2015,high,65000000,43482270,177814791,221297061,156297061,340.4570169230769
Birth of the Dragon,"Action,Biography,Drama",Action,"['Biography', 'Drama']",8,2017,mid,31000000,6901965,318525,7220490,-23779510,23.29190322580645
Jungle Shuffle,"Adventure,Animation",Adventure,['Animation'],3,2015,mid,10000000,0,360898,360898,-9639102,3.60898
The Sleepwalker,Drama,Drama,[],11,2014,low,1100000,2636,0,2636,-1097364,0.23963636363636365
The Longest Ride,"Drama,Romance",Drama,['Romance'],4,2015,mid,34000000,37446117,26356811,63802928,29802928,187.6556705882353
The Christmas Candle,"Drama,Family",Drama,['Family'],11,2013,mid,7000000,1632000,301829,1933829,-5066171,27.62612857142857
Rosewater,"Biography,Drama",Biography,['Drama'],11,2014,mid,10000000,3128941,56776,3185717,-6814283,31.85717
Devil's Due,"Horror,Mystery,Thriller",Horror,"['Mystery', 'Thriller']",1,2014,mid,7000000,15821461,20324626,36146087,29146087,516.3726714285715
Sinister 2,"Horror,Mystery,Thriller",Horror,"['Mystery', 'Thriller']",8,2015,mid,10000000,27740955,26363270,54104225,44104225,541.04225
Faith Connections,"Biography,Documentary,Drama",Biography,"['Documentary', 'Drama']",9,2014,low,550000,9111,0,9111,-540889,1.6565454545454545
Veronica Mars,"Crime,Drama,Mystery",Crime,"['Drama', 'Mystery']",3,2014,mid,6000000,3322127,163256,3485383,-2514617,58.08971666666667
Thank You for Your Service,"Biography,Drama,War",Biography,"['Drama', 'War']",10,2017,mid,20000000,9479390,505926,9985316,-10014684,49.92658
Top Five,"Comedy,Romance",Comedy,['Romance'],12,2014,mid,12000000,25317379,684362,26001741,14001741,216.681175
The Opposite Sex,Comedy,Comedy,[],1,2015,low,3300000,0,50206,50206,-3249794,1.5213939393939395
Annihilation,"Adventure,Drama,Horror",Adventure,"['Drama', 'Horror']",2,2018,high,55000000,32732301,10338614,43070915,-11929085,78.31075454545454
Atlas Shrugged: Who Is John Galt?,"Drama,Mystery,Sci-Fi",Drama,"['Mystery', 'Sci-Fi']",9,2014,mid,5000000,851690,0,851690,-4148310,17.0338
Kingsman: The Secret Service,"Action,Adventure,Comedy",Action,"['Adventure', 'Comedy']",2,2015,high,94000000,128261724,276300000,404561724,310561724,430.38481276595746
United Passions,"Drama,History,Sport",Drama,"['History', 'Sport']",6,2015,mid,30000000,918,167914,168832,-29831168,0.5627733333333333
Furious 7,"Action,Crime,Thriller",Action,"['Crime', 'Thriller']",4,2015,high,190000000,353007020,1165715774,1518722794,1328722794,799.3277863157895
Rock Dog,"Adventure,Animation,Comedy",Adventure,"['Animation', 'Comedy']",2,2017,high,60000000,9420546,14727942,24148488,-35851512,40.24748
Mike and Dave Need Wedding Dates,"Adventure,Comedy,Romance",Adventure,"['Comedy', 'Romance']",7,2016,mid,33000000,46009673,29888427,75898100,42898100,229.99424242424246
A Haunted House 2,"Comedy,Fantasy",Comedy,['Fantasy'],4,2014,low,4000000,17329487,3877374,21206861,17206861,530.171525
Pitch Perfect 2,"Comedy,Music",Comedy,['Music'],5,2015,mid,29000000,184296230,103329238,287625468,258625468,991.8119586206897
Heli,"Crime,Drama,Romance",Crime,"['Drama', 'Romance']",12,2013,low,1000000,0,552614,552614,-447386,55.2614
Ride Along 2,"Action,Comedy,Crime",Action,"['Comedy', 'Crime']",1,2016,mid,40000000,90862685,33964631,124827316,84827316,312.06829
Wish I Was Here,"Comedy,Drama",Comedy,['Drama'],7,2014,mid,6000000,3591299,3000066,6591365,591365,109.85608333333334
Nightcrawler,"Crime,Drama,Thriller",Crime,"['Drama', 'Thriller']",10,2014,mid,8500000,32381218,17953200,50334418,41834418,592.1696235294118
Red Sparrow,"Action,Drama,Thriller",Action,"['Drama', 'Thriller']",3,2018,high,69000000,46874505,99077356,145951861,76951861,211.52443623188404
I Origins,"Drama,Romance,Sci-Fi",Drama,"['Romance', 'Sci-Fi']",7,2014,low,1000000,336472,515927,852399,-147601,85.2399
Manglehorn,Drama,Drama,[],6,2015,low,4000000,132270,665169,797439,-3202561,19.935975
Obvious Child,"Comedy,Drama,Romance",Comedy,"['Drama', 'Romance']",6,2014,low,1000000,3122616,201454,3324070,2324070,332.407
The Signal,"Drama,Mystery,Sci-Fi",Drama,"['Mystery', 'Sci-Fi']",6,2014,low,4000000,600896,2064426,2665322,-1334678,66.63305000000001
The Dressmaker,"Comedy,Drama",Comedy,['Drama'],9,2016,mid,11900000,2022115,22019502,24041617,12141617,202.0303949579832
John Wick,"Action,Crime,Thriller",Action,"['Crime', 'Thriller']",10,2014,mid,30000000,43037835,33197166,76235001,46235001,254.11666999999997
The Looking Glass,"Drama,Music",Drama,['Music'],10,2015,low,300000,1711,0,1711,-298289,0.5703333333333334
R100,"Comedy,Drama",Comedy,['Drama'],1,2015,mid,5500000,24956,0,24956,-5475044,0.4537454545454545
The Lazarus Effect,"Horror,Mystery,Sci-Fi",Horror,"['Mystery', 'Sci-Fi']",2,2015,mid,5000000,25801570,12557740,38359310,33359310,767.1862
American Heist,"Action,Crime,Drama",Action,"['Crime', 'Drama']",7,2015,mid,10000000,0,2341218,2341218,-7658782,23.41218
Higher Power,"Action,Sci-Fi,Thriller",Action,"['Sci-Fi', 'Thriller']",5,2018,low,500000,528,0,528,-499472,0.10560000000000001
Father Figures,Documentary,Documentary,[],12,2017,mid,25000000,17501244,3537197,21038441,-3961559,84.153764
A Most Violent Year,"Crime,Drama,Thriller",Crime,"['Drama', 'Thriller']",12,2014,mid,20000000,5749134,3097741,8846875,-11153125,44.234375
The Transporter Refueled,"Action,Adventure,Crime",Action,"['Adventure', 'Crime']",9,2015,mid,22000000,16029670,53668825,69698495,47698495,316.8113409090909
Zootopia,"Adventure,Animation,Comedy",Adventure,"['Animation', 'Comedy']",3,2016,high,150000000,341268248,678161368,1019429616,869429616,679.6197440000001
Focus,Comedy,Comedy,[],2,2015,high,65000000,53862963,114202737,168065700,103065700,258.5626153846154
Greater,"Biography,Family,Sport",Biography,"['Family', 'Sport']",8,2016,mid,9000000,2000093,0,2000093,-6999907,22.223255555555554
Happy Christmas,"Comedy,Drama",Comedy,['Drama'],7,2014,low,70000,30312,0,30312,-39688,43.30285714285714
Hot Pursuit,"Action,Comedy,Crime",Action,"['Comedy', 'Crime']",5,2015,mid,35000000,34580201,11091311,45671512,10671512,130.49003428571427
Alvin and the Chipmunks: The Road Chip,"Adventure,Animation,Comedy",Adventure,"['Animation', 'Comedy']",12,2015,high,90000000,85886987,163630969,249517956,159517956,277.2421733333333
The Purge: Anarchy,"Action,Horror,Sci-Fi",Action,"['Horror', 'Sci-Fi']",7,2014,mid,9000000,71562550,39972331,111534881,102534881,1239.2764555555555
Batman v Superman: Dawn of Justice,"Action,Adventure,Fantasy",Action,"['Adventure', 'Fantasy']",3,2016,high,250000000,330360194,537140087,867500281,617500281,347.0001124
Dolphin Tale 2,"Drama,Family",Drama,['Family'],9,2014,mid,36000000,42024533,15800000,57824533,21824533,160.62370277777777
A Hologram for the King,"Comedy,Drama,Romance",Comedy,"['Drama', 'Romance']",4,2016,mid,35000000,4212494,7633516,11846010,-23153990,33.84574285714286
The Theory of Everything,"Biography,Drama,Romance",Biography,"['Drama', 'Romance']",11,2014,mid,15000000,35893537,87434155,123327692,108327692,822.1846133333333
The Hundred-Foot Journey,"Comedy,Drama",Comedy,['Drama'],8,2014,mid,22000000,54235441,40035047,94270488,72270488,428.50221818181814
Camp X-Ray,"Drama,War",Drama,['War'],10,2014,low,1000000,9837,91216,101053,-898947,10.1053
The Water Diviner,"Drama,History,War",Drama,"['History', 'War']",4,2015,mid,22500000,4200117,26854610,31054727,8554727,138.02100888888887
Shame,Drama,Drama,[],12,2011,mid,6500000,4002293,16410548,20412841,13912841,314.0437076923077
The Lego Ninjago Movie,"Action,Adventure,Animation",Action,"['Adventure', 'Animation']",9,2017,high,70000000,59281555,63455646,122737201,52737201,175.33885857142857
Criminal,"Action,Crime,Drama",Action,"['Crime', 'Drama']",4,2016,mid,31500000,14708696,24062566,38771262,7271262,123.08337142857143
The Jungle Book,"Adventure,Drama,Family",Adventure,"['Drama', 'Family']",4,2016,high,175000000,364001123,598853424,962854547,787854547,550.2025982857143
Mortdecai,"Action,Comedy,Crime",Action,"['Comedy', 'Crime']",1,2015,high,60000000,7696134,22700000,30396134,-29603866,50.660223333333334
Hardcore Henry,"Action,Adventure,Sci-Fi",Action,"['Adventure', 'Sci-Fi']",4,2016,low,2000000,9252038,7935396,17187434,15187434,859.3717
The Past is a Grotesque Animal,"Biography,Documentary,Music",Biography,"['Documentary', 'Music']",6,2014,low,100000,20056,0,20056,-79944,20.055999999999997
Suffragette,"Biography,Drama,History",Biography,"['Drama', 'History']",10,2015,mid,14000000,4702420,29342489,34044909,20044909,243.1779214285714
Monster Trucks,"Action,Adventure,Comedy",Action,"['Adventure', 'Comedy']",1,2017,high,125000000,33370166,28272632,61642798,-63357202,49.3142384
Tusk,"Comedy,Drama,Horror",Comedy,"['Drama', 'Horror']",9,2014,low,3000000,1821983,65571,1887554,-1112446,62.91846666666666
Barfi,"Comedy,Romance",Comedy,['Romance'],9,2012,low,4600000,2804874,33947110,36751984,32151984,798.9561739130435
The Masked Saint,"Action,Biography,Crime",Action,"['Biography', 'Crime']",1,2016,low,3500000,182695,0,182695,-3317305,5.219857142857142
Crazy Rich Asians,"Comedy,Romance",Comedy,['Romance'],8,2018,mid,30000000,174532921,63566790,238099711,208099711,793.6657033333333
Road Hard,Comedy,Comedy,[],3,2015,low,1500000,113169,0,113169,-1386831,7.5446
Now You See Me 2,"Action,Adventure,Comedy",Action,"['Adventure', 'Comedy']",6,2016,high,90000000,65075540,263249467,328325007,238325007,364.80556333333334
Beyond the Lights,"Drama,Music,Romance",Drama,"['Music', 'Romance']",11,2014,mid,7000000,14618727,0,14618727,7618727,208.83895714285714
Unsullied,"Action,Horror,Thriller",Action,"['Horror', 'Thriller']",4,2016,low,1500000,510957,0,510957,-989043,34.0638
Hits,"Comedy,Drama",Comedy,['Drama'],2,2015,low,1000000,15156,0,15156,-984844,1.5155999999999998
Thunder and the House of Magic,"Adventure,Animation,Comedy",Adventure,"['Animation', 'Comedy']",9,2014,mid,34000000,4091,62578429,62582520,28582520,184.06623529411766
Trainwreck,"Comedy,Drama,Romance",Comedy,"['Drama', 'Romance']",7,2015,mid,35000000,110212700,30911197,141123897,106123897,403.2111342857143
Dawn of the Crescent Moon,"Drama,Sci-Fi,Thriller",Drama,"['Sci-Fi', 'Thriller']",7,2015,low,75000,8799,0,8799,-66201,11.732
Rock the Kasbah,"Comedy,Music,War",Comedy,"['Music', 'War']",10,2015,mid,15000000,3020665,365488,3386153,-11613847,22.574353333333335
Room,"Drama,Thriller",Drama,['Thriller'],10,2015,mid,13000000,14677674,21585109,36262783,23262783,278.9444846153846
The Diary of a Teenage Girl,"Comedy,Drama,Romance",Comedy,"['Drama', 'Romance']",8,2015,low,2000000,1477002,802957,2279959,279959,113.99794999999999
The Boy Next Door,"Horror,Thriller",Horror,['Thriller'],1,2015,low,4000000,36006065,17395873,53401938,49401938,1335.04845
Bitter Harvest,"Drama,Romance,War",Drama,"['Romance', 'War']",2,2017,mid,21000000,557241,48921,606162,-20393838,2.8864857142857145
Fantastic Beasts and Where to Find Them,"Adventure,Family,Fantasy",Adventure,"['Family', 'Fantasy']",11,2016,high,180000000,234037575,568365278,802402853,622402853,445.7793627777778
Brooklyn,"Drama,Music,Musical",Drama,"['Music', 'Musical']",11,2015,mid,11000000,38322743,23753398,62076141,51076141,564.3285545454545
Fences,"Drama,Family",Drama,['Family'],12,2016,mid,24000000,57682904,6599977,64282881,40282881,267.8453375
Son of God,"Biography,Drama,History",Biography,"['Drama', 'History']",2,2014,mid,22000000,59700064,11249729,70949793,48949793,322.4990590909091
I Am Wrath,"Action,Crime,Drama",Action,"['Crime', 'Drama']",4,2016,mid,18000000,0,309608,309608,-17690392,1.7200444444444445
Incarnate,"Horror,Thriller",Horror,['Thriller'],12,2016,mid,5000000,4799774,4571262,9371036,4371036,187.42072000000002
Risen,"Action,Adventure,Drama",Action,"['Adventure', 'Drama']",2,2016,mid,20000000,36880033,9375730,46255763,26255763,231.27881499999998
It Follows,"Horror,Mystery",Horror,['Mystery'],3,2015,low,2000000,14674077,8576678,23250755,21250755,1162.5377500000002
The Bounce Back,"Comedy,Romance",Comedy,['Romance'],12,2016,low,3000000,321910,99494,421404,-2578596,14.046800000000001
Sully,"Biography,Drama",Biography,['Drama'],9,2016,high,60000000,125070033,113454523,238524556,178524556,397.5409266666667
The Three Musketeers,Adventure,Adventure,[],10,2011,high,90000000,20377913,119500000,139877913,49877913,155.41990333333334
Creative Control,"Drama,Sci-Fi",Drama,['Sci-Fi'],3,2016,low,1000000,63014,0,63014,-936986,6.3014
Welcome to Marwen,"Biography,Comedy,Drama",Biography,"['Comedy', 'Drama']",12,2018,mid,45000000,10763520,2111402,12874922,-32125078,28.610937777777778
The Revenant,Horror,Horror,[],12,2015,high,135000000,183637894,349300408,532938302,397938302,394.7691125925926
London Has Fallen,"Action,Thriller",Action,['Thriller'],3,2016,high,60000000,62524260,132669825,195194085,135194085,325.323475
War Horse,Drama,Drama,[],12,2011,high,70000000,79883359,76932170,156815529,86815529,224.02218428571427
Logan,"Action,Drama,Sci-Fi",Action,"['Drama', 'Sci-Fi']",3,2017,high,127000000,226277068,389184326,615461394,488461394,484.61527086614177
American Ultra,"Action,Comedy,Sci-Fi",Action,"['Comedy', 'Sci-Fi']",8,2015,mid,28000000,14439985,15855043,30295028,2295028,108.19652857142856
Still Alice,Drama,Drama,[],1,2015,mid,5000000,18656400,23043212,41699612,36699612,833.99224
Regression,"Crime,Horror,Mystery",Crime,"['Horror', 'Mystery']",10,2015,mid,20000000,55039,15769335,15824374,-4175626,79.12187
Annabelle,"Horror,Mystery,Thriller",Horror,"['Mystery', 'Thriller']",10,2014,mid,6500000,84273813,172589107,256862920,250362920,3951.7372307692303
Pan,"Adventure,Comedy,Family",Adventure,"['Comedy', 'Family']",10,2015,high,150000000,35088320,116437653,151525973,1525973,101.01731533333333
Jigsaw,"Crime,Horror,Mystery",Crime,"['Horror', 'Mystery']",10,2017,mid,10000000,38052832,64392364,102445196,92445196,1024.45196
Compadres,"Action,Comedy,Crime",Action,"['Comedy', 'Crime']",4,2016,low,3000000,3127773,4317271,7445044,4445044,248.16813333333334
Max,"Adventure,Drama,Family",Adventure,"['Drama', 'Family']",6,2015,mid,20000000,42656255,1001902,43658157,23658157,218.290785
Transformers: The Last Knight,"Action,Adventure,Sci-Fi",Action,"['Adventure', 'Sci-Fi']",6,2017,high,217000000,130168683,472724657,602893340,385893340,277.8310322580645
The Brothers Grimsby,"Action,Adventure,Comedy",Action,"['Adventure', 'Comedy']",3,2016,mid,35000000,6864016,21856454,28720470,-6279530,82.05848571428571
X-Men: Apocalypse,"Action,Adventure,Sci-Fi",Action,"['Adventure', 'Sci-Fi']",5,2016,high,178000000,155442489,387095057,542537546,364537546,304.7963741573034
Jack Reacher: Never Go Back,"Action,Thriller",Action,['Thriller'],10,2016,high,60000000,58697076,101249413,159946489,99946489,266.57748166666664
Sicario,"Action,Crime,Drama",Action,"['Crime', 'Drama']",9,2015,mid,30000000,46889293,37504456,84393749,54393749,281.3124966666666
Fist Fight,Comedy,Comedy,[],2,2017,mid,25000000,32187017,8099399,40286416,15286416,161.145664
Murder on the Orient Express,"Crime,Drama,Mystery",Crime,"['Drama', 'Mystery']",11,2017,high,55000000,102826543,243096187,345922730,290922730,628.9504181818182
Ferdinand,"Adventure,Animation,Comedy",Adventure,"['Animation', 'Comedy']",12,2017,high,111000000,84410380,205437550,289847930,178847930,261.12426126126127
A Monster Calls,"Animation,Drama,Fantasy",Animation,"['Drama', 'Fantasy']",1,2017,mid,43000000,3740823,42673707,46414530,3414530,107.94076744186047
Ice Age: Collision Course,"Adventure,Animation,Comedy",Adventure,"['Animation', 'Comedy']",7,2016,high,105000000,64063008,338093674,402156682,297156682,383.0063638095238
The Last Station,Documentary,Documentary,[],1,2010,mid,18000000,6617867,9078279,15696146,-2303854,87.20081111111111
Paul Blart: Mall Cop 2,"Action,Comedy,Crime",Action,"['Comedy', 'Crime']",4,2015,mid,38000000,71091594,36559052,107650646,69650646,283.29117368421055
War for the Planet of the Apes,"Action,Adventure,Drama",Action,"['Adventure', 'Drama']",7,2017,high,152000000,146880162,342712105,489592267,337592267,322.10017565789474
10 Days in a Madhouse,Drama,Drama,[],11,2015,mid,12000000,14616,0,14616,-11985384,0.12179999999999999
The Hateful Eight,"Crime,Drama,Mystery",Crime,"['Drama', 'Mystery']",12,2015,high,62000000,54117416,93747470,147864886,85864886,238.49175161290322
The Lobster,"Comedy,Drama,Romance",Comedy,"['Drama', 'Romance']",3,2016,low,4500000,9196278,8823556,18019834,13519834,400.4407555555556
Despicable Me 3,"Adventure,Animation,Comedy",Adventure,"['Animation', 'Comedy']",6,2017,high,75000000,264624300,770103450,1034727750,959727750,1379.637
Z Storm,"Action,Crime",Action,['Crime'],8,2015,mid,7000000,0,2053330,2053330,-4946670,29.33328571428571
Sing,"Animation,Comedy,Family",Animation,"['Comedy', 'Family']",12,2016,high,75000000,270329045,364125744,634454789,559454789,845.9397186666667
The Nut Job 2: Nutty by Nature,"Adventure,Animation,Comedy",Adventure,"['Animation', 'Comedy']",8,2017,mid,40000000,28370522,29067867,57438389,17438389,143.59597250000002
The Walk,"Adventure,Biography,Drama",Adventure,"['Biography', 'Drama']",9,2015,mid,35000000,10161183,51330921,61492104,26492104,175.6917257142857
Captain America: Civil War,"Action,Adventure,Sci-Fi",Action,"['Adventure', 'Sci-Fi']",5,2016,high,250000000,408084349,731985064,1140069413,890069413,456.0277652
Race,"Biography,Drama,Sport",Biography,"['Drama', 'Sport']",2,2016,mid,5000000,19115191,4630581,23745772,18745772,474.91544
Thor: Ragnarok,"Action,Adventure,Comedy",Action,"['Adventure', 'Comedy']",11,2017,high,180000000,315058289,531921735,846980024,666980024,470.5444577777778
Housebound,"Comedy,Horror,Mystery",Comedy,"['Horror', 'Mystery']",10,2014,low,1500000,0,236863,236863,-1263137,15.790866666666666
The Word,"Drama,Thriller",Drama,['Thriller'],3,2014,low,200000,3648,0,3648,-196352,1.8239999999999998
The Disaster Artist,"Biography,Comedy,Drama",Biography,"['Comedy', 'Drama']",12,2017,mid,10000000,21120616,7597051,28717667,18717667,287.17667
Moana,"Adventure,Animation,Comedy",Adventure,"['Animation', 'Comedy']",11,2016,high,150000000,248757044,388760321,637517365,487517365,425.0115766666666
Mechanic: Resurrection,"Action,Adventure,Thriller",Action,"['Adventure', 'Thriller']",8,2016,mid,40000000,21218403,88520437,109738840,69738840,274.3471
American Made,"Action,Biography,Comedy",Action,"['Biography', 'Comedy']",9,2017,high,50000000,51342000,84227212,135569212,85569212,271.138424
Whiskey Tango Foxtrot,"Biography,Comedy,Drama",Biography,"['Comedy', 'Drama']",3,2016,mid,35000000,23083334,2267413,25350747,-9649253,72.43070571428572
Girls Trip,"Comedy,Drama",Comedy,['Drama'],7,2017,mid,28000000,115108515,25777838,140886353,112886353,503.1655464285715
Vaalu,"Comedy,Romance",Comedy,['Romance'],12,2015,low,1900000,0,12444,12444,-1887556,0.6549473684210526
The Visit,"Horror,Mystery,Thriller",Horror,"['Mystery', 'Thriller']",9,2015,mid,5000000,65206105,33471711,98677816,93677816,1973.5563200000001
Legend,"Biography,Crime,Drama",Biography,"['Crime', 'Drama']",11,2015,mid,25000000,1872994,40552456,42425450,17425450,169.7018
Not Cool,"Comedy,Drama,Romance",Comedy,"['Drama', 'Romance']",9,2014,low,800000,35688,0,35688,-764312,4.460999999999999
Bilal: A New Breed of Hero,"Action,Adventure,Animation",Action,"['Adventure', 'Animation']",2,2018,mid,30000000,490973,157626,648599,-29351401,2.1619966666666666
Cars 3,"Adventure,Animation,Comedy",Adventure,"['Animation', 'Comedy']",6,2017,high,175000000,152901115,230640254,383541369,208541369,219.16649657142858
Incredibles 2,"Action,Adventure,Animation",Action,"['Adventure', 'Animation']",6,2018,high,200000000,608581744,633938967,1242520711,1042520711,621.2603555000001
A Street Cat Named Bob,"Biography,Comedy,Drama",Biography,"['Comedy', 'Drama']",11,2016,mid,8000000,82703,17299990,17382693,9382693,217.2836625
Jem and the Holograms,"Adventure,Drama,Family",Adventure,"['Drama', 'Family']",10,2015,mid,5000000,2184640,184297,2368937,-2631063,47.37874
Paper Towns,"Comedy,Drama,Mystery",Comedy,"['Drama', 'Mystery']",7,2015,mid,12000000,32000304,53450180,85450484,73450484,712.0873666666666
Ricki and the Flash,"Comedy,Drama,Music",Comedy,"['Drama', 'Music']",8,2015,mid,18000000,26839498,14326535,41166033,23166033,228.70018333333334
Barbershop: The Next Cut,"Comedy,Drama",Comedy,['Drama'],4,2016,mid,20000000,54030051,374151,54404202,34404202,272.02101
Allied,"Action,Drama,Romance",Action,"['Drama', 'Romance']",11,2016,high,106000000,40098064,79168597,119266661,13266661,112.5157179245283
Misconduct,"Crime,Drama,Mystery",Crime,"['Drama', 'Mystery']",2,2016,mid,11000000,0,2352511,2352511,-8647489,21.386463636363636
The Martian,"Adventure,Drama,Sci-Fi",Adventure,"['Drama', 'Sci-Fi']",10,2015,high,108000000,228433663,426837780,655271443,547271443,606.7328175925926
Bodom,"Horror,Mystery,Thriller",Horror,"['Mystery', 'Thriller']",12,2016,low,1250000,0,726460,726460,-523540,58.116800000000005
Bridge of Spies,"Drama,History,Thriller",Drama,"['History', 'Thriller']",10,2015,mid,40000000,72313754,90184584,162498338,122498338,406.24584500000003
Criminal Activities,"Crime,Drama,Thriller",Crime,"['Drama', 'Thriller']",11,2015,mid,7000000,0,386744,386744,-6613256,5.524914285714286
The BFG,"Adventure,Family,Fantasy",Adventure,"['Family', 'Fantasy']",7,2016,high,140000000,55483770,144162910,199646680,59646680,142.6047714285714
Creature,"Biography,Crime,Documentary",Biography,"['Crime', 'Documentary']",9,2011,low,3000000,331000,0,331000,-2669000,11.033333333333333
The Other Side of the Door,Horror,Horror,[],3,2016,mid,5000000,3000342,9904765,12905107,7905107,258.10214
Unfriended,"Horror,Mystery,Thriller",Horror,"['Mystery', 'Thriller']",4,2015,low,1000000,32789645,31574553,64364198,63364198,6436.419800000001
Underworld: Blood Wars,"Action,Adventure,Fantasy",Action,"['Adventure', 'Fantasy']",1,2017,mid,35000000,30353973,50855249,81209222,46209222,232.0263485714286
Power Rangers,"Action,Adventure,Sci-Fi",Action,"['Adventure', 'Sci-Fi']",3,2017,high,120000000,85364450,57167102,142531552,22531552,118.77629333333333
My All-American,"Biography,Drama,Sport",Biography,"['Drama', 'Sport']",11,2015,mid,20000000,2246000,0,2246000,-17754000,11.23
American Honey,"Adventure,Drama,Romance",Adventure,"['Drama', 'Romance']",9,2016,low,3500000,663247,1948503,2611750,-888250,74.62142857142857
The Lady in the Van,"Biography,Comedy,Drama",Biography,"['Comedy', 'Drama']",1,2016,mid,6000000,10021175,32299328,42320503,36320503,705.3417166666667
Kong: Skull Island,"Action,Adventure,Fantasy",Action,"['Adventure', 'Fantasy']",3,2017,high,185000000,168052812,393019247,561072059,376072059,303.28219405405406
Godzilla: King of the Monsters,"Action,Adventure,Fantasy",Action,"['Adventure', 'Fantasy']",5,2019,high,170000000,85576941,213700000,299276941,129276941,176.0452594117647
The Losers,Drama,Drama,[],4,2010,mid,25000000,23591432,6272408,29863840,4863840,119.45536000000001
Rogue One: A Star Wars Story,"Action,Adventure,Sci-Fi",Action,"['Adventure', 'Sci-Fi']",12,2016,high,200000000,532177324,516925532,1049102856,849102856,524.551428
My Big Fat Greek Wedding 2,"Comedy,Romance",Comedy,['Romance'],3,2016,mid,18000000,59689605,32406953,92096558,74096558,511.6475444444444
The Equalizer 2,"Action,Crime,Thriller",Action,"['Crime', 'Thriller']",7,2018,high,77000000,102084362,88368770,190453132,113453132,247.34172987012988
Snowden,"Biography,Drama,Thriller",Biography,"['Drama', 'Thriller']",9,2016,high,50000000,21587519,13793399,35380918,-14619082,70.761836
Solo: A Star Wars Story,"Action,Adventure,Fantasy",Action,"['Adventure', 'Fantasy']",5,2018,high,275000000,213767512,179383835,393151347,118151347,142.9641261818182
Won't Back Down,Sport,Sport,[],9,2012,mid,19000000,5310554,434949,5745503,-13254497,30.239489473684213
La La Land,"Comedy,Drama,Music",Comedy,"['Drama', 'Music']",12,2016,mid,20000000,151101803,275249360,426351163,406351163,2131.755815
Lincoln,"Biography,Documentary,History",Biography,"['Documentary', 'History']",11,2012,high,65000000,182207973,91138308,273346281,208346281,420.53274
We Are Your Friends,"Drama,Music,Romance",Drama,"['Music', 'Romance']",8,2015,low,2000000,3591417,6561998,10153415,8153415,507.67075000000006
The Nice Guys,"Action,Comedy,Crime",Action,"['Comedy', 'Crime']",5,2016,high,50000000,36261763,23334984,59596747,9596747,119.19349400000002
Cop Car,"Crime,Thriller",Crime,['Thriller'],8,2015,mid,5000000,134552,9106,143658,-4856342,2.87316
The Predator,"Action,Adventure,Sci-Fi",Action,"['Adventure', 'Sci-Fi']",9,2018,high,88000000,51024708,108462855,159487563,71487563,181.23586704545454
Only the Brave,"Action,Biography,Drama",Action,"['Biography', 'Drama']",10,2017,mid,38000000,18340051,6215126,24555177,-13444823,64.61888684210525
War Room,Drama,Drama,[],8,2015,low,3000000,67790117,6185122,73975239,70975239,2465.8413
31,"Horror,Thriller",Horror,['Thriller'],10,2016,low,1500000,779820,142907,922727,-577273,61.51513333333334
Yoga Hosers,"Action,Comedy,Fantasy",Action,"['Comedy', 'Fantasy']",9,2016,mid,5000000,0,22958,22958,-4977042,0.45916
The Overnight,"Comedy,Mystery",Comedy,['Mystery'],6,2015,low,200000,1109808,56188,1165996,965996,582.998
Dope,"Comedy,Crime,Drama",Comedy,"['Crime', 'Drama']",6,2015,mid,7000000,17506470,684361,18190831,11190831,259.8690142857143
Krampus,"Comedy,Fantasy,Horror",Comedy,"['Fantasy', 'Horror']",12,2015,mid,15000000,42725475,19062918,61788393,46788393,411.92262
The Bronze,"Comedy,Drama,Sport",Comedy,"['Drama', 'Sport']",3,2016,low,3500000,615816,0,615816,-2884184,17.594742857142855
Dumbo,"Adventure,Family,Fantasy",Adventure,"['Family', 'Fantasy']",3,2019,high,170000000,113883318,231121104,345004422,175004422,202.94377764705885
The Perfect Guy,"Crime,Drama,Horror",Crime,"['Drama', 'Horror']",9,2015,mid,18000000,57027435,3250731,60278166,42278166,334.87870000000004
Bajrangi Bhaijaan,"Action,Comedy,Drama",Action,"['Comedy', 'Drama']",7,2015,mid,13000000,8178001,113600346,121778347,108778347,936.7565153846155
The Boss Baby,"Adventure,Animation,Comedy",Adventure,"['Animation', 'Comedy']",3,2017,high,125000000,175003033,335875729,510878762,385878762,408.70300960000003
The Boy,"Horror,Mystery,Thriller",Horror,"['Mystery', 'Thriller']",1,2016,mid,10000000,35819556,32401396,68220952,58220952,682.20952
Baby Driver,"Action,Crime,Drama",Action,"['Crime', 'Drama']",6,2017,mid,34000000,107825862,120278323,228104185,194104185,670.8946617647059
The Space Between Us,"Adventure,Drama,Romance",Adventure,"['Drama', 'Romance']",2,2017,mid,30000000,7885294,8596111,16481405,-13518595,54.93801666666667
Teenage Mutant Ninja Turtles: Out of the Shadows,"Action,Adventure,Comedy",Action,"['Adventure', 'Comedy']",6,2016,high,135000000,82051601,163276773,245328374,110328374,181.72472148148148
Popstar: Never Stop Never Stopping,"Comedy,Music",Comedy,['Music'],6,2016,mid,20000000,9496130,40990,9537120,-10462880,47.6856
Mustang,Drama,Drama,[],11,2015,low,1400000,845464,4707120,5552584,4152584,396.61314285714286
Hercules,Comedy,Comedy,[],7,2014,high,100000000,72688614,170700000,243388614,143388614,243.388614
Meet the Mormons,Documentary,Documentary,[],10,2014,low,2000000,6047363,1808,6049171,4049171,302.45855
The Bye Bye Man,"Drama,Fantasy,Horror",Drama,"['Fantasy', 'Horror']",1,2017,mid,7400000,22395806,8791921,31187727,23787727,421.45577027027025
Manchester by the Sea,Drama,Drama,[],11,2016,mid,8500000,47695371,30038496,77733867,69233867,914.5160823529412
Swiss Army Man,"Adventure,Comedy,Drama",Adventure,"['Comedy', 'Drama']",6,2016,low,3000000,4210454,1626657,5837111,2837111,194.57036666666667
Maze Runner: The Scorch Trials,"Action,Sci-Fi,Thriller",Action,"['Sci-Fi', 'Thriller']",9,2015,high,61000000,81697192,228868970,310566162,249566162,509.12485573770493
The Shallows,"Drama,Horror,Thriller",Drama,"['Horror', 'Thriller']",6,2016,mid,13000000,55121623,63641819,118763442,105763442,913.5649384615384
Green Room,"Horror,Music,Thriller",Horror,"['Music', 'Thriller']",4,2016,mid,5000000,3220371,587132,3807503,-1192497,76.15006
The Darkest Minds,"Action,Adventure,Drama",Action,"['Adventure', 'Drama']",8,2018,mid,34000000,12695691,25665737,38361428,4361428,112.82772941176471
Life During Wartime,"Documentary,History",Documentary,['History'],7,2010,low,4500000,281447,0,281447,-4218553,6.254377777777778
Sardaar Ji,"Comedy,Fantasy,Horror",Comedy,"['Fantasy', 'Horror']",12,2015,low,2700000,0,8200000,8200000,5500000,303.7037037037037
Dheepan,"Crime,Drama",Crime,['Drama'],5,2016,mid,9000000,248795,7455562,7704357,-1295643,85.60396666666666
The Purge: Election Year,"Action,Horror,Sci-Fi",Action,"['Horror', 'Sci-Fi']",7,2016,mid,10000000,79042440,39472287,118514727,108514727,1185.14727
Forever My Girl,"Drama,Music,Romance",Drama,"['Music', 'Romance']",1,2018,low,3500000,16376066,0,16376066,12876066,467.88759999999996
The Lego Batman Movie,"Action,Animation,Comedy",Action,"['Animation', 'Comedy']",2,2017,high,80000000,175750384,134909634,310660018,230660018,388.3250225
The Divide,Western,Western,[],1,2012,low,3000000,18000,138362,156362,-2843638,5.212066666666667
Fantastic Beasts: The Crimes of Grindelwald,"Adventure,Family,Fantasy",Adventure,"['Family', 'Fantasy']",11,2018,high,200000000,159555901,492664185,652220086,452220086,326.110043
Florence Foster Jenkins,"Biography,Comedy,Drama",Biography,"['Comedy', 'Drama']",8,2016,mid,29000000,27383770,28616569,56000339,27000339,193.10461724137932
Keanu,"Action,Comedy,Crime",Action,"['Comedy', 'Crime']",4,2016,mid,15000000,20591853,96288,20688141,5688141,137.92094
Captain Marvel,"Action,Adventure,Sci-Fi",Action,"['Adventure', 'Sci-Fi']",3,2019,high,175000000,426525952,696535598,1123061550,948061550,641.7494571428572
Avengers: Infinity War,"Action,Adventure,Sci-Fi",Action,"['Adventure', 'Sci-Fi']",4,2018,high,300000000,678815482,1369318718,2048134200,1748134200,682.7114
Free Fire,"Action,Comedy,Crime",Action,"['Comedy', 'Crime']",4,2017,mid,10000000,1799322,1994417,3793739,-6206261,37.93739
Warrior,Drama,Drama,[],9,2011,mid,25000000,13657115,10558270,24215385,-784615,96.86154
Woodlawn,"Drama,Sport",Drama,['Sport'],10,2015,mid,13000000,14394097,9606,14403703,1403703,110.79771538461539
Meet the Blacks,"Comedy,Horror",Comedy,['Horror'],4,2016,low,900000,9097072,0,9097072,8197072,1010.7857777777778
The Birth of a Nation,"Biography,Drama,History",Biography,"['Drama', 'History']",10,2016,mid,10000000,15861566,1029445,16891011,6891011,168.91011
Jason Bourne,"Action,Thriller",Action,['Thriller'],7,2016,high,120000000,162192920,253975396,416168316,296168316,346.80692999999997
Top Spin,Documentary,Documentary,[],8,2015,low,150000,5858,0,5858,-144142,3.9053333333333335
The Fits,"Drama,Music",Drama,['Music'],6,2016,low,170000,166425,2817,169242,-758,99.55411764705883
The Darkest Hour,"Documentary,News",Documentary,['News'],12,2011,mid,34800000,21443494,41388221,62831715,28031715,180.5509051724138
Kicks,"Adventure,Drama",Adventure,['Drama'],9,2016,mid,10000000,150191,0,150191,-9849809,1.50191
Miracles from Heaven,"Biography,Drama,Family",Biography,"['Drama', 'Family']",3,2016,mid,13000000,61705123,12093613,73798736,60798736,567.6825846153847
Krisha,Drama,Drama,[],3,2016,low,30000,144822,0,144822,114822,482.74
The Founder,"Biography,Drama,History",Biography,"['Drama', 'History']",1,2017,mid,15000000,12786053,11617139,24403192,9403192,162.68794666666665
Wonder Woman,"Documentary,Drama,Sport",Documentary,"['Drama', 'Sport']",6,2017,high,150000000,412563408,408569970,821133378,671133378,547.422252
By the Sea,Drama,Drama,[],11,2015,mid,20000000,538460,3189286,3727746,-16272254,18.63873
Kubo and the Two Strings,"Action,Adventure,Animation",Action,"['Adventure', 'Animation']",8,2016,high,55000000,48023088,29525034,77548122,22548122,140.99658545454545
Triangle,Documentary,Documentary,[],2,2010,mid,12000000,0,1594955,1594955,-10405045,13.291291666666666
Big Eyes,Documentary,Documentary,[],12,2014,mid,10000000,14482031,12835841,27317872,17317872,273.17872
They Will Have to Kill Us First,Documentary,Documentary,[],3,2016,low,600000,0,7943,7943,-592057,1.3238333333333332
90 Minutes in Heaven,Drama,Drama,[],9,2015,mid,5000000,4816142,0,4816142,-183858,96.32284
Queen of Katwe,"Biography,Drama,Sport",Biography,"['Drama', 'Sport']",9,2016,mid,15000000,8874389,1181092,10055481,-4944519,67.03654
Creed,"Crime,Drama",Crime,['Drama'],11,2015,mid,37000000,109767581,63800000,173567581,136567581,469.10157027027026
The Joneses,"Biography,Documentary",Biography,['Documentary'],4,2010,mid,10000000,1475746,2065819,3541565,-6458435,35.41565
Ouija: Origin of Evil,"Drama,Horror,Mystery",Drama,"['Horror', 'Mystery']",10,2016,mid,9000000,35144505,46687361,81831866,72831866,909.2429555555557
Julija in alfa Romeo,Comedy,Comedy,[],12,2015,low,560000,0,8462,8462,-551538,1.5110714285714286
In Dubious Battle,Drama,Drama,[],2,2017,mid,15000000,0,214182,214182,-14785818,1.42788
Two Lovers and a Bear,"Adventure,Drama,Romance",Adventure,"['Drama', 'Romance']",1,2017,mid,6840000,0,22273,22273,-6817727,0.32562865497076027
Neighbors 2: Sorority Rising,Comedy,Comedy,[],5,2016,mid,35000000,55340730,53416891,108757621,73757621,310.73605999999995
Before We Go,"Documentary,Drama,News",Documentary,"['Drama', 'News']",9,2015,low,3000000,37151,446787,483938,-2516062,16.131266666666665
Counting,Documentary,Documentary,[],7,2015,low,50000,8374,0,8374,-41626,16.747999999999998
Shaft,"Action,Comedy,Crime",Action,"['Comedy', 'Crime']",6,2019,mid,30000000,600000,0,600000,-29400000,2.0
Fifty Shades Darker,"Drama,Romance",Drama,['Romance'],2,2017,high,55000000,114434010,266964482,381398492,326398492,693.4518036363636
Fifty Shades Freed,"Drama,Romance,Thriller",Drama,"['Romance', 'Thriller']",2,2018,high,55000000,100407760,270942859,371350619,316350619,675.1829436363637
Gifted,Drama,Drama,[],4,2017,mid,7000000,24801212,12163444,36964656,29964656,528.0665142857143
The House,"Comedy,Crime",Comedy,['Crime'],6,2017,mid,40000000,25584504,5607921,31192425,-8807575,77.9810625
Why Him?,Comedy,Comedy,[],12,2016,mid,38000000,60323786,57101370,117425156,79425156,309.01356842105264
The Meddler,"Comedy,Drama,Romance",Comedy,"['Drama', 'Romance']",4,2016,low,3200000,4267219,1259723,5526942,2326942,172.7169375
The Prodigy,"Horror,Thriller",Horror,['Thriller'],2,2019,mid,6000000,14856291,4933421,19789712,13789712,329.8285333333333
Morgan,"Action,Horror,Sci-Fi",Action,"['Horror', 'Sci-Fi']",9,2016,mid,8000000,3915251,3383535,7298786,-701214,91.234825
White Boy Rick,"Crime,Drama",Crime,['Drama'],9,2018,mid,30000000,24004833,1943150,25947983,-4052017,86.49327666666666
Buried,Thriller,Thriller,[],9,2010,low,1987650,1044143,20226147,21270290,19282640,1070.1225064774985
Miss Sloane,"Drama,Thriller",Drama,['Thriller'],11,2016,mid,18000000,3500605,4219025,7719630,-10280370,42.886833333333335
The Invitation,Documentary,Documentary,[],4,2016,low,1000000,231738,123098,354836,-645164,35.483599999999996
Nocturnal Animals,"Drama,Thriller",Drama,['Thriller'],11,2016,mid,22500000,10663357,21735324,32398681,9898681,143.99413777777778
Darkest Hour,"Biography,Drama,History",Biography,"['Drama', 'History']",11,2017,mid,30000000,56443120,94364052,150807172,120807172,502.6905733333333
Mile 22,"Action,Adventure,Thriller",Action,"['Adventure', 'Thriller']",8,2018,mid,35000000,36108758,30186363,66295121,31295121,189.41463142857143
Patriots Day,"Action,Crime,Drama",Action,"['Crime', 'Drama']",12,2016,mid,40000000,31886361,20951628,52837989,12837989,132.09497249999998
Sleight,"Action,Drama,Sci-Fi",Action,"['Drama', 'Sci-Fi']",4,2017,low,250000,3930990,3460,3934450,3684450,1573.78
Christopher Robin,"Adventure,Animation,Comedy",Adventure,"['Animation', 'Comedy']",8,2018,high,75000000,99215042,98289716,197504758,122504758,263.3396773333333
La chambre bleue,Documentary,Documentary,[],10,2014,low,1400000,260441,1684979,1945420,545420,138.95857142857142
The Star,"Adventure,Animation,Comedy",Adventure,"['Animation', 'Comedy']",11,2017,mid,20000000,40847995,21910015,62758010,42758010,313.79005
Karachi se Lahore,"Adventure,Comedy,Family",Adventure,"['Comedy', 'Family']",12,2015,low,1000000,0,17721,17721,-982279,1.7721
Can You Ever Forgive Me?,"Biography,Comedy,Crime",Biography,"['Comedy', 'Crime']",10,2018,mid,10000000,8803865,2948522,11752387,1752387,117.52387
Burnt,"Comedy,Drama",Comedy,['Drama'],10,2015,mid,20000000,13651946,23121564,36773510,16773510,183.86755
Battle of the Sexes,"Biography,Comedy,Drama",Biography,"['Comedy', 'Drama']",9,2017,mid,25000000,12638526,5806853,18445379,-6554621,73.781516
Wolves,"Drama,Sport",Drama,['Sport'],11,2014,mid,18000000,0,94953,94953,-17905047,0.5275166666666666
Storks,"Adventure,Animation,Comedy",Adventure,"['Animation', 'Comedy']",9,2016,high,70000000,72679278,110674153,183353431,113353431,261.9334728571428
The Fate of the Furious,"Action,Crime,Thriller",Action,"['Crime', 'Thriller']",4,2017,high,250000000,225764765,1009081502,1234846267,984846267,493.9385068
Braid,"Horror,Mystery,Thriller",Horror,"['Mystery', 'Thriller']",2,2019,low,1660000,0,80745,80745,-1579255,4.864156626506024
Almost Christmas,"Comedy,Drama",Comedy,['Drama'],11,2016,mid,17000000,42065185,428321,42493506,25493506,249.96179999999998
Kingsman: The Golden Circle,"Action,Adventure,Comedy",Action,"['Adventure', 'Comedy']",9,2017,high,104000000,100234838,308568858,408803696,304803696,393.0804769230769
Bad Moms,Comedy,Comedy,[],7,2016,mid,20000000,113257297,67741419,180998716,160998716,904.9935800000001
All Saints,Drama,Drama,[],8,2017,low,2000000,5802208,139786,5941994,3941994,297.0997
Fifty Shades of Black,Comedy,Comedy,[],1,2016,mid,5000000,11686940,10426135,22113075,17113075,442.26150000000007
Kevin Hart: What Now?,"Comedy,Documentary",Comedy,['Documentary'],10,2016,mid,10000000,23591043,0,23591043,13591043,235.91043
On the Basis of Sex,"Biography,Drama",Biography,['Drama'],12,2018,mid,20000000,24622687,13450690,38073377,18073377,190.366885
Stranded,Documentary,Documentary,[],7,2013,low,1900000,0,285593,285593,-1614407,15.031210526315789
Collateral Beauty,"Drama,Romance",Drama,['Romance'],12,2016,mid,36000000,31016021,54293072,85309093,49309093,236.96970277777777
Lion,"Action,Drama,Romance",Action,"['Drama', 'Romance']",11,2016,mid,12000000,51739495,97831225,149570720,137570720,1246.4226666666666
It Comes at Night,"Horror,Mystery",Horror,['Mystery'],6,2017,mid,5000000,13985117,5735086,19720203,14720203,394.40406
The Sitter,Horror,Horror,[],12,2011,mid,25000000,30542576,8206828,38749404,13749404,154.997616
Hunt for the Wilderpeople,"Adventure,Comedy,Drama",Adventure,"['Comedy', 'Drama']",6,2016,low,2500000,5205471,18640062,23845533,21345533,953.8213199999999
Bumblebee,"Action,Adventure,Sci-Fi",Action,"['Adventure', 'Sci-Fi']",12,2018,high,102000000,127195589,338000000,465195589,363195589,456.07410686274505
Early Man,"Adventure,Animation,Comedy",Adventure,"['Animation', 'Comedy']",2,2018,high,50000000,8267544,37018346,45285890,-4714110,90.57178
Trash,Drama,Drama,[],10,2015,mid,12000000,17484,6535702,6553186,-5446814,54.60988333333333
American Hero,"Action,Comedy,Drama",Action,"['Comedy', 'Drama']",12,2015,low,1000000,0,26,26,-999974,0.0026
The Call,Thriller,Thriller,[],3,2013,mid,12800000,51872378,17949098,69821476,57021476,545.48028125
Air Strike,"Action,Adventure,Drama",Action,"['Adventure', 'Drama']",10,2018,high,65000000,0,516279,516279,-64483721,0.7942753846153847
Unfriended: Dark Web,"Crime,Horror,Mystery",Crime,"['Horror', 'Mystery']",7,2018,low,1000000,8866745,7567843,16434588,15434588,1643.4588
Pitch Perfect 3,"Comedy,Music",Comedy,['Music'],12,2017,mid,45000000,104897530,80838882,185736412,140736412,412.7475822222222
The Master,Documentary,Documentary,[],9,2012,mid,37500000,16247159,34400257,50647416,13147416,135.059776
LBJ,"Biography,Drama,History",Biography,"['Drama', 'History']",11,2017,mid,20000000,2468683,38498,2507181,-17492819,12.535905
The Meg,"Action,Horror,Sci-Fi",Action,"['Horror', 'Sci-Fi']",8,2018,high,178000000,145443742,384086973,529530715,351530715,297.4891657303371
How to Be a Latin Lover,"Comedy,Drama",Comedy,['Drama'],4,2017,mid,10000000,32149404,30406824,62556228,52556228,625.56228
Rough Night,"Comedy,Crime,Thriller",Comedy,"['Crime', 'Thriller']",6,2017,mid,20000000,22105643,24738714,46844357,26844357,234.22178499999998
The Best of Enemies,"Biography,Drama,History",Biography,"['Drama', 'History']",4,2019,mid,10000000,10205616,0,10205616,205616,102.05615999999999
Sultan,"Action,Drama,Sport",Action,"['Drama', 'Sport']",7,2016,mid,11000000,5599781,67390000,72989781,61989781,663.5434636363636
Hidden Figures,"Biography,Drama,History",Biography,"['Drama', 'History']",12,2016,mid,25000000,169607287,62164429,231771716,206771716,927.086864
Blood Feast,Horror,Horror,[],2,2018,low,1200000,8708,0,8708,-1191292,0.7256666666666667
Baahubali 2: The Conclusion,"Action,Drama",Action,['Drama'],4,2017,mid,30000000,18985794,244517120,263502914,233502914,878.3430466666667
Friend Request,Horror,Horror,[],9,2017,mid,9900000,3759078,7551757,11310835,1410835,114.2508585858586
The Perfect Match,"Comedy,Romance",Comedy,['Romance'],3,2016,mid,5000000,9669521,512529,10182050,5182050,203.64100000000002
The Emoji Movie,"Adventure,Animation,Comedy",Adventure,"['Animation', 'Comedy']",7,2017,high,50000000,86089513,130472799,216562312,166562312,433.124624
Jurassic World: Fallen Kingdom,"Action,Adventure,Sci-Fi",Action,"['Adventure', 'Sci-Fi']",6,2018,high,170000000,417719760,888053039,1305772799,1135772799,768.1016464705882
Emily,Documentary,Documentary,[],1,2017,low,27000,3547,0,3547,-23453,13.137037037037036
The Resurrection of Gavin Stone,"Comedy,Drama,Family",Comedy,"['Drama', 'Family']",1,2017,low,2000000,2303792,0,2303792,303792,115.1896
Widows,Comedy,Comedy,[],11,2018,mid,40000000,42402632,31463456,73866088,33866088,184.66522
Rush,"Documentary,News",Documentary,['News'],9,2013,mid,38000000,26947624,71283215,98230839,60230839,258.50220789473684
Lady Bird,"Comedy,Drama",Comedy,['Drama'],11,2017,mid,10000000,48958273,29652496,78610769,68610769,786.1076899999999
The Darkness,Thriller,Thriller,[],5,2016,low,4000000,10753574,144719,10898293,6898293,272.457325
The Sisters Brothers,"Adventure,Comedy,Crime",Adventure,"['Comedy', 'Crime']",9,2018,mid,38000000,3143056,10000000,13143056,-24856944,34.58698947368421
Middle School: The Worst Years of My Life,"Comedy,Family",Comedy,['Family'],10,2016,mid,8500000,20007149,3304144,23311293,14811293,274.25050588235297
The Forest,"Drama,Fantasy,Horror",Drama,"['Fantasy', 'Horror']",1,2016,mid,10000000,26594261,14154969,40749230,30749230,407.4923
Housefull,Family,Family,[],4,2010,mid,10100000,1183658,17542642,18726300,8626300,185.4089108910891
Time to Choose,Documentary,Documentary,[],6,2016,low,3500000,29233,0,29233,-3470767,0.8352285714285714
"Everything, Everything","Drama,Romance",Drama,['Romance'],5,2017,mid,10000000,34121140,27481996,61603136,51603136,616.0313600000001
Dunkirk,"Action,Drama,History",Action,"['Drama', 'History']",7,2017,high,150000000,190068280,309769088,499837368,349837368,333.224912
"Three Billboards Outside Ebbing, Missouri","Crime,Drama",Crime,['Drama'],11,2017,mid,12000000,54513740,105678175,160191915,148191915,1334.9326250000001
Mary Poppins Returns,"Comedy,Family,Fantasy",Comedy,"['Family', 'Fantasy']",12,2018,high,130000000,171958438,169570080,341528518,211528518,262.7142446153846
Get Out,"Horror,Mystery,Thriller",Horror,"['Mystery', 'Thriller']",2,2017,mid,5000000,176040665,79327286,255367951,250367951,5107.35902
Sicario: Day of the Soldado,"Action,Crime,Drama",Action,"['Crime', 'Drama']",6,2018,mid,35000000,50065850,25819346,75885196,40885196,216.81484571428572
Safe Haven,Horror,Horror,[],2,2013,mid,28000000,71399120,22651831,94050951,66050951,335.8962535714286
The Favourite,"Biography,Drama,History",Biography,"['Drama', 'History']",11,2018,mid,15000000,34366783,59747146,94113929,79113929,627.4261933333333
Ant-Man and the Wasp,"Action,Adventure,Comedy",Action,"['Adventure', 'Comedy']",7,2018,high,130000000,216648740,406495920,623144660,493144660,479.3420461538462
The Three Stooges,Documentary,Documentary,[],4,2012,mid,30000000,44338224,9714025,54052249,24052249,180.17416333333333
The Secret Life of Pets 2,"Adventure,Animation,Comedy",Adventure,"['Animation', 'Comedy']",6,2019,high,80000000,63795655,49555841,113351496,33351496,141.68937
Peter Rabbit,"Adventure,Animation,Comedy",Adventure,"['Animation', 'Comedy']",2,2018,high,50000000,115234093,231902384,347136477,297136477,694.272954
The Eagle,Documentary,Documentary,[],2,2011,mid,25000000,19490041,19503507,38993548,13993548,155.974192
Paul,Drama,Drama,[],3,2011,mid,40000000,37412945,63749161,101162106,61162106,252.905265
Annabelle: Creation,"Horror,Mystery,Thriller",Horror,"['Mystery', 'Thriller']",8,2017,mid,15000000,102092201,203292664,305384865,290384865,2035.8990999999999
Mommy,Drama,Drama,[],1,2015,low,4900000,3498695,14037309,17536004,12636004,357.87763265306126
"Love, Simon","Comedy,Drama,Romance",Comedy,"['Drama', 'Romance']",3,2018,mid,10000000,40826341,24694292,65520633,55520633,655.20633
Weekend,Horror,Horror,[],9,2011,low,190000,484592,1092993,1577585,1387585,830.3078947368422
The Drop,Documentary,Documentary,[],9,2014,mid,12600000,10724389,8330145,19054534,6454534,151.22646031746032
Wuthering Heights,"Horror,Romance",Horror,['Romance'],10,2012,mid,8000000,100915,2620619,2721534,-5278466,34.019175000000004
Hotel Transylvania 3: Summer Vacation,"Adventure,Animation,Comedy",Adventure,"['Animation', 'Comedy']",7,2018,high,65000000,167500092,359579870,527079962,462079962,810.8922492307693
The Gunman,Western,Western,[],3,2015,mid,40000000,10664749,7929478,18594227,-21405773,46.4855675
Paterson,"Comedy,Drama,Romance",Comedy,"['Drama', 'Romance']",12,2016,mid,5000000,2141423,8586113,10727536,5727536,214.55071999999998
Snatched,"Drama,Horror,Mystery",Drama,"['Horror', 'Mystery']",5,2017,mid,42000000,45852178,11999999,57852177,15852177,137.74327857142856
Marshall,"Biography,Crime,Drama",Biography,"['Crime', 'Drama']",10,2017,mid,12000000,10051659,65157,10116816,-1883184,84.30680000000001
Happy Death Day,"Horror,Mystery,Thriller",Horror,"['Mystery', 'Thriller']",10,2017,mid,5000000,55683845,69326415,125010260,120010260,2500.2052
Sgt. Stubby: An American Hero,"Adventure,Animation,Family",Adventure,"['Animation', 'Family']",4,2018,mid,25000000,3054285,591672,3645957,-21354043,14.583827999999999
The Little Prince,Documentary,Documentary,[],2,2016,high,77500000,1311213,100717706,102028919,24528919,131.65021806451614
Wish Upon,"Drama,Fantasy,Horror",Drama,"['Fantasy', 'Horror']",7,2017,mid,12000000,14301505,9175840,23477345,11477345,195.64454166666667
Nerve,"Documentary,History",Documentary,['History'],7,2016,mid,20000000,38583626,32068658,70652284,50652284,353.26142
Lights Out,Documentary,Documentary,[],7,2016,mid,5000000,67268835,81537675,148806510,143806510,2976.1302
Lean on Pete,"Adventure,Drama",Adventure,['Drama'],4,2018,mid,8000000,1163056,1291971,2455027,-5544973,30.687837499999997
The Hurricane Heist,"Action,Adventure,Crime",Action,"['Adventure', 'Crime']",3,2018,mid,40000000,6115824,24847860,30963684,-9036316,77.40921
Shanghai,Drama,Drama,[],10,2015,high,50000000,46425,15459497,15505922,-34494078,31.011844
Logan Lucky,"Comedy,Crime,Drama",Comedy,"['Crime', 'Drama']",8,2017,mid,29000000,27778642,16485629,44264271,15264271,152.6354172413793
The Big Sick,"Comedy,Drama,Romance",Comedy,"['Drama', 'Romance']",6,2017,mid,5000000,42872467,11100393,53972860,48972860,1079.4572
Deadpool 2,"Action,Adventure,Comedy",Action,"['Adventure', 'Comedy']",5,2018,high,110000000,324591735,462088822,786680557,676680557,715.1641427272727
Loving,"Drama,Romance",Drama,['Romance'],11,2016,mid,9000000,7710234,5187830,12898064,3898064,143.31182222222222
Cargo,Drama,Drama,[],10,2011,low,4200000,0,313230,313230,-3886770,7.457857142857143
The Square,Family,Family,[],4,2010,low,1900000,406216,334716,740932,-1159068,38.99642105263158
The Square,Family,Family,[],10,2013,low,1500000,124244,52018,176262,-1323738,11.7508
The Nutcracker and the Four Realms,"Adventure,Family,Fantasy",Adventure,"['Family', 'Fantasy']",11,2018,high,132900000,54858851,115435048,170293899,37393899,128.1368690744921
The Host,Documentary,Documentary,[],3,2013,high,50000000,26623701,37853350,64477051,14477051,128.954102
"I, Tonya","Biography,Comedy,Drama",Biography,"['Comedy', 'Drama']",12,2017,mid,11000000,30014534,23782875,53797409,42797409,489.0673545454545
The Hate U Give,"Crime,Drama",Crime,['Drama'],10,2018,mid,23000000,29719483,5348182,35067665,12067665,152.46810869565218
The Shape of Water,"Adventure,Drama,Fantasy",Adventure,"['Drama', 'Fantasy']",12,2017,mid,19500000,63859435,131931359,195790794,176290794,1004.0553538461538
Unforgettable,"Drama,Romance",Drama,['Romance'],4,2017,mid,12000000,11368012,4853199,16221211,4221211,135.17675833333334
Blood Ties,Documentary,Documentary,[],3,2014,mid,26000000,42472,2881487,2923959,-23076041,11.245996153846153
On the Road,Drama,Drama,[],3,2013,mid,25000000,720828,8592474,9313302,-15686698,37.253208
Thoroughbreds,"Comedy,Crime,Drama",Comedy,"['Crime', 'Drama']",3,2018,mid,5000000,3072605,114697,3187302,-1812698,63.74604
The Florida Project,Drama,Drama,[],10,2017,low,2000000,5904366,5390958,11295324,9295324,564.7662
Goosebumps 2: Haunted Halloween,"Adventure,Comedy,Family",Adventure,"['Comedy', 'Family']",10,2018,mid,35000000,46697321,46594157,93291478,58291478,266.54708
Survivor,"Crime,Thriller",Crime,['Thriller'],5,2015,mid,20000000,0,1703281,1703281,-18296719,8.516405
Sorry to Bother You,"Comedy,Fantasy,Sci-Fi",Comedy,"['Fantasy', 'Sci-Fi']",7,2018,low,3200000,17493096,792464,18285560,15085560,571.42375
Home Again,"Comedy,Drama,Romance",Comedy,"['Drama', 'Romance']",9,2017,mid,15000000,27020284,10316590,37336874,22336874,248.91249333333332
Cold Pursuit,"Action,Crime,Drama",Action,"['Crime', 'Drama']",2,2019,high,60000000,32138862,30460297,62599159,2599159,104.33193166666668
Just Getting Started,"Action,Comedy",Action,['Comedy'],12,2017,mid,22000000,6069605,686807,6756412,-15243588,30.710963636363637
Insidious: The Last Key,"Horror,Mystery,Thriller",Horror,"['Mystery', 'Thriller']",1,2018,mid,10000000,67745330,100140258,167885588,157885588,1678.85588
The Possession of Hannah Grace,"Horror,Mystery,Thriller",Horror,"['Mystery', 'Thriller']",11,2018,mid,6000000,14836174,27949213,42785387,36785387,713.0897833333333
Rio,Drama,Drama,[],4,2011,high,90000000,143619809,343900000,487519809,397519809,541.6886766666667
Skyscraper,"Action,Adventure,Thriller",Action,"['Adventure', 'Thriller']",7,2018,high,125000000,68420120,235695414,304115534,179115534,243.29242720000002
The Lovers,"Comedy,Drama,Romance",Comedy,"['Drama', 'Romance']",3,2015,mid,35000000,0,53899,53899,-34946101,0.15399714285714286
I Am Not Your Negro,Documentary,Documentary,[],2,2017,low,1000000,7123919,2493483,9617402,8617402,961.7402000000001
Oddball,Documentary,Documentary,[],12,2016,mid,7000000,0,10237229,10237229,3237229,146.24612857142859
Hotel Artemis,"Action,Drama,Sci-Fi",Action,"['Drama', 'Sci-Fi']",6,2018,mid,15000000,6708137,6050662,12758799,-2241201,85.05866
The Descendants,Drama,Drama,[],11,2011,mid,20000000,82624961,92882839,175507800,155507800,877.539
Total Recall,Action,Action,[],8,2012,high,125000000,58877969,152978119,211856088,86856088,169.4848704
Another Year,Documentary,Documentary,[],12,2010,mid,8000000,3205706,16799907,20005613,12005613,250.0701625
Denial,Documentary,Documentary,[],9,2016,mid,10000000,4073448,5190492,9263940,-736060,92.63940000000001
Slender Man,"Adventure,Comedy,Horror",Adventure,"['Comedy', 'Horror']",8,2018,mid,10000000,30564825,21158819,51723644,41723644,517.23644
Project X,Mystery,Mystery,[],3,2012,mid,12000000,54731865,48296323,103028188,91028188,858.5682333333333
Dangal,Action,Action,[],12,2016,mid,9500000,12391761,282262857,294654618,285154618,3101.627557894737
The Professor and the Madman,"Biography,Drama,Mystery",Biography,"['Drama', 'Mystery']",5,2019,mid,25000000,0,5227233,5227233,-19772767,20.908932
Moonlight,Horror,Horror,[],10,2016,low,1500000,27854931,37390581,65245512,63745512,4349.7008000000005
Bernie,Family,Family,[],4,2012,mid,6000000,9204489,902486,10106975,4106975,168.44958333333332
Miss Bala,"Action,Crime,Drama",Action,"['Crime', 'Drama']",2,2019,mid,15000000,14998027,364271,15362298,362298,102.41532
Captive State,"Sci-Fi,Thriller",Sci-Fi,['Thriller'],3,2019,mid,25000000,5958315,3034985,8993300,-16006700,35.9732
Left Behind,"Documentary,Drama",Documentary,['Drama'],10,2014,mid,16000000,14019924,6749285,20769209,4769209,129.80755625
"Roman J. Israel, Esq.","Crime,Drama,Thriller",Crime,"['Drama', 'Thriller']",11,2017,mid,22000000,11962712,1004300,12967012,-9032988,58.94096363636364
Diary of a Wimpy Kid: The Long Haul,"Comedy,Family",Comedy,['Family'],5,2017,mid,22000000,20738724,14870853,35609577,13609577,161.86171363636365
Destiny,Western,Western,[],12,2014,low,750000,0,450,450,-749550,0.06
Kin,"Action,Drama,Sci-Fi",Action,"['Drama', 'Sci-Fi']",8,2018,mid,30000000,5718096,4378725,10096821,-19903179,33.65607
The Perfect Host,Fantasy,Fantasy,[],7,2011,low,1000000,48764,2823,51587,-948413,5.1587000000000005
First Reformed,"Drama,Mystery,Thriller",Drama,"['Mystery', 'Thriller']",5,2018,low,3500000,3448256,426516,3874772,374772,110.70777142857142
Acrimony,"Drama,Romance,Thriller",Drama,"['Romance', 'Thriller']",3,2018,mid,20000000,43549096,3078740,46627836,26627836,233.13918
Life,Comedy,Comedy,[],3,2017,high,58000000,30234022,70695644,100929666,42929666,174.01666551724136
Limitless,Documentary,Documentary,[],3,2011,mid,27000000,79249455,76315464,155564919,128564919,576.1663666666666
Burn,Thriller,Thriller,[],7,2012,low,225000,1109276,0,1109276,884276,493.0115555555555
Barbecue,Documentary,Documentary,[],12,2014,mid,10000000,388,247177,247565,-9752435,2.47565
Brotherly Love,Drama,Drama,[],4,2015,low,1900000,478595,0,478595,-1421405,25.18921052631579
Knock Knock,Horror,Horror,[],10,2015,low,2000000,36336,6292180,6328516,4328516,316.4258
Late Night,"Comedy,Drama",Comedy,['Drama'],6,2019,low,4000000,246305,0,246305,-3753695,6.1576249999999995
The First Purge,"Action,Horror,Sci-Fi",Action,"['Horror', 'Sci-Fi']",7,2018,mid,13000000,69488745,67128560,136617305,123617305,1050.902346153846
Lucy,Documentary,Documentary,[],7,2014,mid,40000000,126573960,330933816,457507776,417507776,1143.76944
Split,"Action,Drama,Sport",Action,"['Drama', 'Sport']",1,2017,mid,5000000,138141585,140823221,278964806,273964806,5579.29612
The Runaways,Adventure,Adventure,[],3,2010,mid,9500000,3573673,1704959,5278632,-4221368,55.56454736842106
Posledniy bogatyr,"Action,Adventure,Comedy",Action,"['Adventure', 'Comedy']",12,2017,mid,8500000,0,30700192,30700192,22200192,361.1787294117647
Smallfoot,"Adventure,Animation,Comedy",Adventure,"['Animation', 'Comedy']",9,2018,high,80000000,83240103,130451174,213691277,133691277,267.11409625
The Judge,Documentary,Documentary,[],10,2014,high,50000000,47119388,29000000,76119388,26119388,152.238776
The Town,Horror,Horror,[],9,2010,mid,37000000,92186262,60380619,152566881,115566881,412.3429216216216
A Ghost Story,"Drama,Fantasy,Romance",Drama,"['Fantasy', 'Romance']",7,2017,low,100000,1594798,1174984,2769782,2669782,2769.782
Vice,"Biography,Comedy,Drama",Biography,"['Comedy', 'Drama']",12,2018,high,60000000,47836282,23046889,70883171,10883171,118.13861833333333
Black or White,"Action,Drama,Thriller",Action,"['Drama', 'Thriller']",1,2015,mid,9000000,21571189,399832,21971021,12971021,244.12245555555555
Patti Cake$,"Drama,Music",Drama,['Music'],8,2017,low,1000000,800148,670942,1471090,471090,147.109
The Post,"Biography,Drama,History",Biography,"['Drama', 'History']",12,2017,high,50000000,81903458,97845422,179748880,129748880,359.49775999999997
Adrift,"Action,Adventure,Biography",Action,"['Adventure', 'Biography']",6,2018,mid,35000000,31445011,26452180,57897191,22897191,165.4205457142857
Alpha,"Crime,Drama,Fantasy",Crime,"['Drama', 'Fantasy']",8,2018,high,51000000,35851379,63773494,99624873,48624873,195.3428882352941
Life as We Know It,Comedy,Comedy,[],10,2010,mid,38000000,53374681,52513156,105887837,67887837,278.6522026315789
Creed II,"Drama,Sport",Drama,['Sport'],11,2018,high,50000000,115715889,97875633,213591522,163591522,427.18304399999994
Stolen,Drama,Drama,[],9,2012,mid,35000000,289773,17677973,17967746,-17032254,51.33641714285714
The Night Before,Documentary,Documentary,[],11,2015,mid,25000000,43035725,9391621,52427346,27427346,209.709384
A Bad Moms Christmas,"Adventure,Comedy",Adventure,['Comedy'],11,2017,mid,28000000,72110659,55599891,127710550,99710550,456.10910714285717
Safe,Thriller,Thriller,[],4,2012,mid,33000000,17142080,24353133,41495213,8495213,125.74306969696968
Proud Mary,"Action,Crime,Drama",Action,"['Crime', 'Drama']",1,2018,mid,30000000,20868638,840901,21709539,-8290461,72.36513
Wonder Park,"Adventure,Animation,Comedy",Adventure,"['Animation', 'Comedy']",3,2019,high,100000000,45216793,69932629,115149422,15149422,115.149422
I Can Only Imagine,"Biography,Drama,Family",Biography,"['Drama', 'Family']",3,2018,mid,7000000,83482352,2121869,85604221,78604221,1222.917442857143
Five Feet Apart,"Drama,Romance",Drama,['Romance'],3,2019,mid,7000000,45729221,34775200,80504421,73504421,1150.0631571428573
Serenity,"Drama,Mystery,Sci-Fi",Drama,"['Mystery', 'Sci-Fi']",1,2019,mid,25000000,8547045,2819984,11367029,-13632971,45.468115999999995
Action Point,Comedy,Comedy,[],6,2018,mid,19000000,5059608,44067,5103675,-13896325,26.861447368421054
Indivisible,"Drama,War",Drama,['War'],10,2018,low,2700000,3511417,76888,3588305,888305,132.9001851851852
The Apparition,Drama,Drama,[],8,2012,mid,17000000,4936819,5700462,10637281,-6362719,62.57224117647059
Dark Phoenix,"Action,Adventure,Sci-Fi",Action,"['Adventure', 'Sci-Fi']",6,2019,high,350000000,42762350,107000000,149762350,-200237650,42.78924285714286
Drive,"Action,Crime,Drama",Action,"['Crime', 'Drama']",9,2011,mid,15000000,35060689,46297241,81357930,66357930,542.3861999999999
The Immigrant,Drama,Drama,[],5,2014,mid,16000000,2013456,5571555,7585011,-8414989,47.40631875
No Strings Attached,"Comedy,Drama,Romance",Comedy,"['Drama', 'Romance']",1,2011,mid,25000000,70662220,78565858,149228078,124228078,596.912312
Bad Times at the El Royale,"Crime,Drama,Mystery",Crime,"['Drama', 'Mystery']",10,2018,mid,32000000,17839115,11365264,29204379,-2795621,91.263684375
A Quiet Place,"Drama,Horror,Sci-Fi",Drama,"['Horror', 'Sci-Fi']",4,2018,mid,17000000,188024361,146497933,334522294,317522294,1967.7782
Youth,"Drama,Romance,War",Drama,"['Romance', 'War']",12,2015,mid,13000000,2703296,21298277,24001573,11001573,184.62748461538462
Carnage,Comedy,Comedy,[],12,2011,mid,25000000,2546747,35565407,38112154,13112154,152.448616
The Artist,Mystery,Mystery,[],11,2011,mid,16000000,44667095,83589617,128256712,112256712,801.6044499999999
Safe House,Horror,Horror,[],2,2012,high,85000000,126181630,82360532,208542162,123542162,245.34372000000002
The Intruder,"Drama,Horror,Mystery",Drama,"['Horror', 'Mystery']",5,2019,mid,8000000,35095904,909967,36005871,28005871,450.07338749999997
Concussion,Documentary,Documentary,[],12,2015,mid,35000000,34531832,15831958,50363790,15363790,143.89654285714286
The Awakening,Thriller,Thriller,[],8,2012,low,4900000,95933,6828388,6924321,2024321,141.31267346938776
Upgrade,Drama,Drama,[],6,2018,low,3000000,11977130,4576155,16553285,13553285,551.7761666666667
Night School,Comedy,Comedy,[],9,2018,mid,29000000,77339130,25669662,103008792,74008792,355.2027310344827
I Feel Pretty,"Comedy,Romance",Comedy,['Romance'],4,2018,mid,32000000,48795601,42758196,91553797,59553797,286.105615625
The 15:17 to Paris,"Biography,Drama,Thriller",Biography,"['Drama', 'Thriller']",2,2018,mid,30000000,36276286,19819914,56096200,26096200,186.98733333333334
The Kid Who Would Be King,"Action,Adventure,Family",Action,"['Adventure', 'Family']",1,2019,high,59000000,16790790,11557656,28348446,-30651554,48.048213559322036
Glass,"Drama,Sci-Fi,Thriller",Drama,"['Sci-Fi', 'Thriller']",1,2019,mid,20000000,111035005,134268500,245303505,225303505,1226.517525
Peppermint,"Action,Crime,Drama",Action,"['Crime', 'Drama']",9,2018,mid,25000000,35418723,16382035,51800758,26800758,207.203032
Wanderlust,Documentary,Documentary,[],2,2012,mid,32500000,17288155,6871779,24159934,-8340066,74.33825846153846
Us,"Horror,Mystery,Thriller",Horror,"['Mystery', 'Thriller']",3,2019,mid,20000000,175006930,79203380,254210310,234210310,1271.05155
Book Club,"Comedy,Drama,Romance",Comedy,"['Drama', 'Romance']",5,2018,mid,10000000,68566296,22547387,91113683,81113683,911.13683
Kill the Irishman,Crime,Crime,[],3,2011,mid,12000000,1188194,0,1188194,-10811806,9.901616666666667
Truth or Dare,"Comedy,Drama,Romance",Comedy,"['Drama', 'Romance']",4,2018,low,3500000,41411015,53716329,95127344,91627344,2717.9241142857145
Life of the Party,Drama,Drama,[],5,2018,mid,30000000,53059911,12700000,65759911,35759911,219.19970333333333
Addicted,Drama,Drama,[],10,2014,mid,5000000,17390770,108472,17499242,12499242,349.98483999999996
Red Sky,"Drama,War",Drama,['War'],3,2015,mid,25000000,0,91116,91116,-24908884,0.364464
Do You Believe?,"Fantasy,Horror",Fantasy,['Horror'],3,2015,low,2300000,12985600,1319331,14304931,12004931,621.9535217391305
Green Book,"Biography,Comedy,Drama",Biography,"['Comedy', 'Drama']",11,2018,mid,23000000,85080171,236954268,322034439,299034439,1400.1497347826087
Test,Drama,Drama,[],6,2014,low,250000,18823,0,18823,-231177,7.5291999999999994
Underdogs,"Documentary,Sport",Documentary,['Sport'],8,2013,low,2500000,35017,1357632,1392649,-1107351,55.70596
Mandy,"Action,Fantasy,Horror",Action,"['Fantasy', 'Horror']",9,2018,mid,6000000,1214525,213131,1427656,-4572344,23.794266666666665
Coco,Horror,Horror,[],11,2017,high,175000000,209726015,588282086,798008101,623008101,456.0046291428572
Eighth Grade,"Comedy,Drama",Comedy,['Drama'],7,2018,low,2000000,13539710,801306,14341016,12341016,717.0508
Animal Kingdom,"Drama,Fantasy,Horror",Drama,"['Fantasy', 'Horror']",8,2010,low,4200000,1044039,7034644,8078683,3878683,192.34959523809522
Departure,Drama,Drama,[],3,2017,low,1100000,0,27561,27561,-1072439,2.5055454545454543
First Man,Documentary,Documentary,[],10,2018,high,60000000,44936545,60267280,105203825,45203825,175.33970833333333
A Simple Favor,"Comedy,Crime,Drama",Comedy,"['Crime', 'Drama']",9,2018,mid,20000000,53548586,44080131,97628717,77628717,488.143585
The Family,Comedy,Comedy,[],9,2013,mid,30000000,36918811,14159730,51078541,21078541,170.26180333333335
Let Me In,Horror,Horror,[],10,2010,mid,20000000,12134935,16135464,28270399,8270399,141.351995
If Beale Street Could Talk,"Drama,Romance",Drama,['Romance'],12,2018,mid,12000000,14915773,4943394,19859167,7859167,165.49305833333335
Stronger,"Action,Sport",Action,['Sport'],9,2017,mid,30000000,4211129,4575623,8786752,-21213248,29.289173333333334
Destroyer,"Action,Crime,Drama",Action,"['Crime', 'Drama']",12,2018,mid,9000000,1533324,2147772,3681096,-5318904,40.90106666666667
Breaking In,"Action,Crime,Drama",Action,"['Crime', 'Drama']",5,2018,mid,6000000,46840590,4571030,51411620,45411620,856.8603333333334
Unsane,"Drama,Horror,Mystery",Drama,"['Horror', 'Mystery']",3,2018,low,1500000,7690044,6554887,14244931,12744931,949.6620666666666
Hearts Beat Loud,"Comedy,Drama,Music",Comedy,"['Drama', 'Music']",6,2018,low,2000000,2386254,34708,2420962,420962,121.04809999999999
Churchill,Biography,Biography,[],6,2017,mid,10000000,1279681,6302515,7582196,-2417804,75.82196
Freedom,Thriller,Thriller,[],6,2015,mid,14500000,0,872757,872757,-13627243,6.019013793103448
Arrival,Documentary,Documentary,[],11,2016,mid,47000000,100546139,102581755,203127894,156127894,432.1870085106383
Uncle Drew,"Comedy,Sport",Comedy,['Sport'],6,2018,mid,18000000,42469946,4057215,46527161,28527161,258.4842277777778
BlacKkKlansman,"Biography,Crime,Drama",Biography,"['Crime', 'Drama']",8,2018,mid,15000000,49275340,43741995,93017335,78017335,620.1155666666667
Getaway,Thriller,Thriller,[],8,2013,mid,18000000,10501938,1312051,11813989,-6186011,65.63327222222223
El Chicano,Drama,Drama,[],5,2019,mid,8000000,700261,0,700261,-7299739,8.7532625
"Paul, Apostle of Christ","Adventure,Biography,Drama",Adventure,"['Biography', 'Drama']",3,2018,mid,5000000,17547999,7981499,25529498,20529498,510.58995999999996
The Interview,Documentary,Documentary,[],2,2014,mid,44000000,6105175,6237457,12342632,-31657368,28.051436363636363
Instant Family,"Comedy,Drama",Comedy,['Drama'],11,2018,mid,48000000,67363237,52372951,119736188,71736188,249.45039166666666
Devil,Drama,Drama,[],9,2010,mid,10000000,33679655,29674459,63354114,53354114,633.54114
Anna,"Action,Thriller",Action,['Thriller'],6,2014,low,4357373,0,1200000,1200000,-3157373,27.539528977666127
Super,Adventure,Adventure,[],4,2011,low,2500000,327716,266217,593933,-1906067,23.75732
Sinister,Drama,Drama,[],10,2012,low,3000000,48086903,39640904,87727807,84727807,2924.2602333333334
Above and Beyond,Documentary,Documentary,[],1,2015,low,1300000,288751,0,288751,-1011249,22.211615384615385
Hugo,Documentary,Documentary,[],11,2011,high,180000000,73864507,106183277,180047784,47784,100.02654666666666
Absentia,Sci-Fi,Sci-Fi,[],12,2011,low,70000,0,8555,8555,-61445,12.221428571428572
The Conspirator,Comedy,Comedy,[],4,2011,mid,25000000,11538204,4369207,15907411,-9092589,63.629644
The Thing,Documentary,Documentary,[],10,2011,mid,38000000,16999934,10573144,27573078,-10426922,72.56073157894737
The Great Wall,Documentary,Documentary,[],2,2017,high,150000000,45157105,289329747,334486852,184486852,222.99123466666666
The Wall,Documentary,Documentary,[],5,2017,low,3000000,1803064,2692198,4495262,1495262,149.84206666666665
Melancholia,Documentary,Documentary,[],11,2011,mid,9400000,3030848,18786450,21817298,12417298,232.098914893617
Phantom,"Crime,Horror,Thriller",Crime,"['Horror', 'Thriller']",3,2013,mid,18000000,1034589,164921,1199510,-16800490,6.663944444444445
Anonymous,"Action,Comedy,Mystery",Action,"['Comedy', 'Mystery']",10,2011,mid,27500000,4463292,11352217,15815509,-11684491,57.51094181818181
What Men Want,"Comedy,Fantasy,Romance",Comedy,"['Fantasy', 'Romance']",2,2019,mid,20000000,54611903,15300000,69911903,49911903,349.55951500000003
Let There Be Light,Drama,Drama,[],10,2017,low,3000000,7233471,7838,7241309,4241309,241.37696666666665
Annie,"Comedy,Musical",Comedy,['Musical'],12,2014,high,65000000,85911262,53918363,139829625,74829625,215.1225
Promised Land,Documentary,Documentary,[],1,2013,mid,15000000,7597898,4796664,12394562,-2605438,82.63041333333334
Tomorrowland,Documentary,Documentary,[],5,2015,high,170000000,93436322,113191196,206627518,36627518,121.54559882352942
Hereditary,"Drama,Horror,Mystery",Drama,"['Horror', 'Mystery']",6,2018,mid,10000000,44069456,26064449,70133905,60133905,701.33905
Spotlight,Drama,Drama,[],11,2015,mid,20000000,45055776,47032684,92088460,72088460,460.4423
Conviction,Drama,Drama,[],10,2010,mid,12500000,6797696,5029284,11826980,-673020,94.61583999999999
Abduction,"Action,Sci-Fi",Action,['Sci-Fi'],9,2011,mid,35000000,28087155,58561204,86648359,51648359,247.56673999999998
Tooth Fairy,Horror,Horror,[],1,2010,mid,48000000,60022256,52588130,112610386,64610386,234.6049708333333
The Mule,"Crime,Drama,Thriller",Crime,"['Drama', 'Thriller']",12,2018,high,50000000,103804407,67053269,170857676,120857676,341.715352
Dragon Ball Super: Broly,"Action,Adventure,Animation",Action,"['Adventure', 'Animation']",1,2019,mid,8500000,30376755,92371000,122747755,114247755,1444.0912352941175
Heist,"Action,Crime,Drama",Action,"['Crime', 'Drama']",11,2015,mid,8900000,50136,3273995,3324131,-5575869,37.34978651685393
Remember Me,Thriller,Thriller,[],3,2010,mid,16000000,19068240,37437880,56506120,40506120,353.16325
Circle,Drama,Drama,[],8,2010,low,2000000,10024,0,10024,-1989976,0.5012
Teefa in Trouble,"Action,Comedy,Crime",Action,"['Comedy', 'Crime']",7,2018,low,1500000,0,98806,98806,-1401194,6.587066666666666
Chloe,"Documentary,Family",Documentary,['Family'],3,2010,mid,13000000,3075255,8755876,11831131,-1168869,91.0087
Happy Death Day 2U,"Drama,Horror,Mystery",Drama,"['Horror', 'Mystery']",2,2019,mid,9000000,28051045,36128450,64179495,55179495,713.1055
All You Need Is Love,"Comedy,Romance",Comedy,['Romance'],10,2014,low,300000,0,3565259,3565259,3265259,1188.4196666666667
Trance,Documentary,Documentary,[],4,2013,mid,16000000,2322593,20271459,22594052,6594052,141.212825
Monsters,"Drama,Thriller",Drama,['Thriller'],10,2010,low,500000,237301,5402429,5639730,5139730,1127.946
One Day,Drama,Drama,[],8,2011,mid,15000000,13843771,45324921,59168692,44168692,394.45794666666666
Silence,Drama,Drama,[],12,2016,mid,46500000,7100177,16626449,23726626,-22773374,51.02500215053764
Mama,Drama,Drama,[],1,2013,mid,15000000,71628180,76467386,148095566,133095566,987.3037733333333
Unfinished Business,Romance,Romance,[],3,2015,mid,35000000,10219501,2994550,13214051,-21785949,37.75443142857143
Paranoia,Drama,Drama,[],8,2013,mid,40000000,7388654,8952113,16340767,-23659233,40.8519175
Brave,Drama,Drama,[],6,2012,high,185000000,237282182,317324350,554606532,369606532,299.7873145945946
Trespass,Western,Western,[],10,2011,mid,35000000,16816,769716,786532,-34213468,2.2472342857142857
Joe,Drama,Drama,[],4,2014,low,4000000,373375,0,373375,-3626625,9.334375
Restless,"Documentary,Drama",Documentary,['Drama'],9,2011,mid,8000000,163753,2608758,2772511,-5227489,34.6563875
Upside Down,Comedy,Comedy,[],3,2013,high,50000000,102118,26284921,26387039,-23612961,52.774078
Frontera,"Crime,Drama,Family",Crime,"['Drama', 'Family']",9,2014,low,2300000,59696,0,59696,-2240304,2.595478260869565
Tag,"Action,Comedy",Action,['Comedy'],6,2018,mid,28000000,54730625,22295561,77026186,49026186,275.0935214285714
Robin Hood,"Action,Adventure,History",Action,"['Adventure', 'History']",5,2010,high,210000000,105487148,216971858,322459006,112459006,153.55190761904763
Robin Hood,"Action,Adventure,History",Action,"['Adventure', 'History']",11,2018,high,99000000,30824628,53922813,84747441,-14252559,85.60347575757575
3,Documentary,Documentary,[],9,2011,mid,7200000,59774,235718,295492,-6904508,4.104055555555555
Fahrenheit 11/9,Documentary,Documentary,[],9,2018,mid,5000000,6352306,301409,6653715,1653715,133.0743
Redemption,Drama,Drama,[],6,2013,mid,23000000,36686,13556787,13593473,-9406527,59.10205652173913
Get Hard,Comedy,Comedy,[],3,2015,mid,40000000,90411453,16100000,106511453,66511453,266.2786325
The Circle,Drama,Drama,[],4,2017,mid,18000000,20497844,20154020,40651864,22651864,225.8436888888889
Like Crazy,Drama,Drama,[],10,2011,low,250000,3395391,333009,3728400,3478400,1491.3600000000001
Stitches,Drama,Drama,[],4,2013,low,2000000,0,63555,63555,-1936445,3.17775
The Last Stand,Drama,Drama,[],1,2013,mid,30000000,12050299,36280458,48330757,18330757,161.10252333333332
Trust,"Crime,Drama",Crime,['Drama'],4,2011,low,4000000,120016,0,120016,-3879984,3.0004
Lawless,"Action,Adventure,Documentary",Action,"['Adventure', 'Documentary']",8,2012,mid,26000000,37397291,16996396,54393687,28393687,209.20648846153847
The Witch,Horror,Horror,[],2,2016,low,3500000,25138705,15315815,40454520,36954520,1155.8434285714286
Demonic,Documentary,Documentary,[],10,2017,low,3000000,0,4668109,4668109,1668109,155.60363333333333
Wild,Documentary,Documentary,[],12,2014,mid,15000000,37880356,14580187,52460543,37460543,349.73695333333336
Red,Drama,Drama,[],10,2010,high,60000000,90380162,106059531,196439693,136439693,327.3994883333333
Forget Me Not,Documentary,Documentary,[],5,2011,low,1300000,0,13465,13465,-1286535,1.0357692307692308
Cinderella,Drama,Drama,[],3,2015,high,95000000,201151353,333400000,534551353,439551353,562.6856347368421
Joy,Drama,Drama,[],12,2015,high,60000000,56451232,44682827,101134059,41134059,168.556765
Genius,Drama,Drama,[],6,2016,mid,17000000,1361045,5904238,7265283,-9734717,42.73695882352941
The Tree of Life,Documentary,Documentary,[],5,2011,mid,35000000,13305665,48416161,61721826,26721826,176.3480742857143
Maggie,Drama,Drama,[],5,2015,low,4500000,187112,840648,1027760,-3472240,22.83911111111111
Unplanned,"Biography,Drama",Biography,['Drama'],3,2019,mid,6000000,18107621,0,18107621,12107621,301.7936833333333
Brothers,Action,Action,[],8,2015,mid,13000000,656688,17200000,17856688,4856688,137.35913846153846
"As Above, So Below","Animation,Documentary,Sci-Fi",Animation,"['Documentary', 'Sci-Fi']",8,2014,mid,5000000,21222315,20601751,41824066,36824066,836.4813200000001
Inferno,Horror,Horror,[],10,2016,high,75000000,34343574,185175793,219519367,144519367,292.6924893333333
The Tempest,Drama,Drama,[],12,2010,mid,20000000,277943,0,277943,-19722057,1.389715
Coriolanus,Drama,Drama,[],1,2012,mid,10000000,749641,1429982,2179623,-7820377,21.79623
Beauty and the Beast,"Family,Fantasy,Musical",Family,"['Fantasy', 'Musical']",3,2017,high,160000000,504014165,755185541,1259199706,1099199706,786.99981625
The Gambler,"Action,Sci-Fi,Thriller",Action,"['Sci-Fi', 'Thriller']",12,2014,mid,25000000,33680992,5037039,38718031,13718031,154.872124
The Gift,Romance,Romance,[],8,2015,mid,5000000,43787265,15191212,58978477,53978477,1179.56954
Red Dog,Documentary,Documentary,[],12,2011,mid,9100000,0,20927794,20927794,11827794,229.97575824175823
Kidnap,"Horror,Thriller",Horror,['Thriller'],8,2017,mid,21000000,30718107,4117973,34836080,13836080,165.88609523809524
The Book of Life,Family,Family,[],10,2014,high,50000000,50151543,47500000,97651543,47651543,195.30308599999998
Aladdin,Fantasy,Fantasy,[],5,2019,high,182000000,246734314,372500000,619234314,437234314,340.2386340659341
Home,"Action,History,War",Action,"['History', 'War']",3,2015,high,130000000,177397510,208600386,385997896,255997896,296.92145846153846
Neighbors,Drama,Drama,[],5,2014,mid,18000000,150086800,120857628,270944428,252944428,1505.2468222222221
Into the Woods,"Fantasy,Horror",Fantasy,['Horror'],12,2014,high,56200000,128002372,85114029,213116401,156916401,379.21067793594307
Never Let Me Go,Drama,Drama,[],9,2010,mid,15000000,2434652,8739066,11173718,-3826282,74.49145333333334
The Girl on the Train,"Horror,Mystery,Thriller",Horror,"['Mystery', 'Thriller']",10,2016,mid,45000000,75395035,98883179,174278214,129278214,387.28492
Captive,Drama,Drama,[],9,2015,low,2000000,2583301,208672,2791973,791973,139.59865
The First Time,Drama,Drama,[],10,2012,low,2000000,17061,0,17061,-1982939,0.85305
Sisters,"Action,Drama",Action,['Drama'],12,2015,mid,30000000,87044645,18986015,106030660,76030660,353.43553333333335
The Promise,Drama,Drama,[],4,2017,high,90000000,8224288,2327129,10551417,-79448583,11.723796666666667
Columbus,Comedy,Comedy,[],8,2017,low,700000,1017107,93404,1110511,410511,158.64442857142856
Unstoppable,Documentary,Documentary,[],11,2010,high,95000000,81562942,84157979,165720921,70720921,174.4430747368421
